的	_d
和	_h
一	_y
是	_u
不	_b
了	_l
我	_w
啊	_a
哦	_o
在	_z
他	_t
人	_r
这	_v
个	_g
们	_m
你	_n
就	_j
去	_q
可	_k
出	_i
下	_x
二	_e
所	_s
方	_f
才	_c
平	_p
有	R_
来	G_
上	Y_
说	U_
也	C_
大	D_
着	E_
到	T_
为	<_
中	O_
好	X_
时	B_
没	V_
要	Q_
那	N_
地	F_
看	J_
道	K_
用	M_
家	A_
之	Z_
会	I_
成	L_
发	W_
与	S_
其	H_
被	P_
子	Dz
得	Db
她	Xc
以	Vi
里	Bf
么	Rv
而	Tq
过	Jz
自	Rq
生	Re
小	Vx
对	Xj
于	Tj
还	Gz
能	Vn
作	Ip
多	Nn
然	Nd
天	Td
都	Zp
事	Jo
点	Yo
学	Md
年	If
国	Qe
又	Xy
心	Cx
后	Rt
起	Zc
样	Ge
只	Oa
想	Gq
太	Du
把	Jc
分	A>
儿	Ae
老	Yr
见	Na
本	Gt
同	Nt
话	Uy
如	Xo
些	Zl
行	Dg
什	Iy
文	Ww
法	Vf
数	Kx
种	To
知	Id
十	Ys
两	Ti
三	Vs
现	En
前	Kh
重	Eb
实	Ak
当	Me
意	Yc
无	Fl
定	At
很	Dr
因	Qd
回	Qo
从	Ii
走	Zo
明	Bn
形	Th
笑	Kr
但	Ib
系	Rs
信	Iu
进	Hz
己	Cj
先	Fa
者	Zz
日	Br
给	Sa
动	G>
情	Ye
算	Kq
女	Xn
问	No
使	Ix
手	Js
已	Cy
长	Kt
应	Rm
经	Sx
间	Nb
几	Nj
声	Fp
外	Ny
表	Ep
等	Kf
象	<o
气	Zq
正	Tz
别	Wh
结	Sf
新	Qr
西	Qx
全	Ie
呢	Op
机	Gn
真	Yq
最	Bh
向	Bo
主	Ue
书	Vp
关	Kd
字	Ad
写	As
高	Ug
听	Or
处	Wy
觉	Mn
打	Jj
由	By
据	Jp
白	Bb
工	<g
它	Al
四	Qs
身	Ss
常	Mm
口	Ok
将	Kn
少	Vs_w
再	Tr
图	Qw
门	Nm
边	<z
民	Cl
或	Lo
许	Uf
式	L>
通	Sm
第	Kg
怎	Pc
亲	Qq
体	Ig
则	Mh
义	Xu
却	Fv
光	Ma
力	<l
爱	<r
念	Iv
教	Yd
东	Lv
像	I>
比	Lb
张	Gk
更	Xb
五	Ew
化	Il
活	Vy
论	Ui
提	Jb
必	Cr
花	Hi
吃	Oi
何	Ij
立	Ul
水	Ks
次	K>
合	Ao
总	Ko
钱	Lt
果	Bg
路	Zw
度	Rh
题	Bz
放	<w
部	Uo
叫	Oy
变	Uw
完	Ag
模	Gm
清	Ve
设	Un
解	<m
连	Lz
世	Ls
思	Bc
山	Ws
加	Wj
量	Bt
非	Ef
记	Uc
难	Xe
够	So
服	Np
原	Rb
车	Lc
九	Zj
夫	Df
入	Ru
公	Av
死	Dl
至	Tv
特	Ff
及	Sj
该	Uu
神	Pb
务	W>
管	Ka
各	Wo
内	In
物	Fs
北	Kl
色	<c
目	Qm
美	Ed
制	Fn
若	Hr
即	Rp
集	Eg
元	Ga
指	Jl
满	Vh
风	Nx
安	Ax
受	<x
房	P>
条	Wg
乎	Rj
构	Gs
术	Gu
干	Fg
友	Rx
八	Ab
士	Fs_e
存	Ry
母	Bm
容	Aw
跟	Zr
办	<a
步	Zy
吧	Oc
告	Fo
怕	Yb
金	Lj
姐	Xq
音	Yy
单	Kb
故	Yw
电	Bl
界	Bi
基	Hf
究	Az
器	Od
父	Xf
红	S>
妈	Xm
转	Lg
交	Ux
轻	Lx
期	Hn
近	Rz
词	Uj
树	Gx
英	Hd
块	Fd
微	Dn
取	Hx
七	Lq
爷	Xp
包	Sc
线	St
产	Ur
京	Uv
改	Cw
李	Gd
社	Pf
节	Hp
户	Ph
引	Gy
未	Gw
兴	Mx
照	B>
影	Bv
组	Sq
保	Io
技	Jy
哪	On
百	Tb
研	Tt
科	Tk
苦	Hy
屋	Pt
具	Qa
篇	Kp
深	Va
库	Rl
乐	Cv
罢	Qf
院	Pa
随	Pr
南	Mk
员	Om
消	Vm
黑	Qh
根	Gr
号	Os
需	Mt
场	Fj
师	Ht
足	Zu
品	Oo
须	Vt
刊	Fh
衣	Py
编	Sp
古	Yg
落	Hv
强	Go
离	Wn
功	<>
周	Nf
始	Xv
欢	X>
参	Vd
换	J>
易	Bs
忽	Sd
准	Ke
秋	Tw
称	T>
底	Rc
讲	Uh
志	Fc
低	Ic
留	C>
台	Vo
页	Tm
细	Sb
官	Ac
络	Sw
戏	Xl
章	Yz
约	Ss_r
尽	Rk
层	Pg
黄	Hb
渐	Vl
显	Bw
德	Dy
响	Ob
索	Ya
备	Wb
石	Ts
嘴	Ol
脚	Nv
证	Ut
除	Pi
另	Wl
共	Ha
持	Jf
买	Vk
久	<u
千	Fq
跑	Zs
错	Lh
视	Pn
令	Is
支	Yx
采	Mg
燕	Hl
举	Mf
输	La
局	Pj
林	Gg
推	Je
陈	Pl
争	<e
冷	Ki
差	E>
奶	Xs
乱	Yl
杂	Zg
联	Hk
永	Uk
列	Dh
赵	Zx
希	Xr
查	Gb
致	Tf
史	Ox
习	Jx
玉	Eu
广	Rg
破	Tp
胡	Yn
闹	Nu
代	Ld
境	Fy
素	Es
群	Eo
描	Jh
谓	Ub
酒	Vq
妹	Xg
飞	Zk
烟	Wq
配	Qc
源	Vr
控	Ja
丽	Tn
供	Ih
治	Vv
市	Um
景	Bu
历	R>
维	Se
味	Og
兰	Kv
奇	Dj
旁	Ua
适	YzS_
毛	El
赶	Zf
肯	Zn
严	Wr
独	Dc
乡	Sr
梅	Gi
际	Ps
余	It
异	Ch
江	V>
园	Qg
土	Ft
料	Kk
费	Gh
河	Vj
皮	Px
替	Dd
优	Iz
互	Te
顶	Jt
罗	Qn
团	Qj
秀	TsX_
协	Y>
谢	Us
双	Xx
征	Dt
吴	Ot
祖	Pq
弄	Eh
耳	He
君	Er
摇	Jm
雨	My
增	Fk
尔	<v
孙	Dv
苏	H>
府	Ri
助	Q>
责	Em
武	Tl
项	<t
族	<i
抱	JsC_
录	Ek
恐	<n
医	Ci
续	Sy
懂	Yh
曼	Bq
闲	Ng
悲	Ec
压	Rf
脑	Nw
恶	Wc
巴	Cb
继	Sk
啦	Oj
杨	Gj
盘	Dq
露	Mz
丁	Jd
琴	Ee
胜	Nr
鬼	Ba
贵	Cm
莫	Mo
右	Ro
趣	Zh
糊	Ky
熟	Uz
狗	Ds
虚	Pw
键	Le
午	Fw
闻	Nh
菜	Hm
农	Ap
温	Vb
访	U>
淡	Vw
盖	Eq
硬	Tx
超	Z>
尚	Ms
食	Ir
庆	Rd
敬	Hs
怜	Yi
银	Lr
灰	Rw
朱	Gz_r
守	Aj
固	Qy
巧	<s
托	Jr
映	Bd
寻	Ej
烦	Wt
醒	Qb
警	Hw
鲁	<b
投	Jn
博	Ym
享	Ud
摆	Jq
铺	Lm
普	Kw
套	De
职	Ho
抬	Jv
汽	Vz
毕	Ly
舍	Ay
秘	Tc
偷	Ia
吹	O>
察	Aa
皇	Be
脱	Nk
迎	Cp
俗	Iw
迷	Kz
宽	Ah
彼	Dp
败	Mw
练	Sl
避	Pu
堆	Fe
径	Dx
徐	Di
昨	Bp
县	Qv
宜	Aq
圈	Qk
掌	Mj
刀	<d
乃	Sn
频	Zd
袋	Lp
甲	Bj
媒	Xh
鞋	<f
鱼	<y
丢	Ev
祥	Pe
姨	Xd
唯	Oe
闪	Ni
米	Km
碗	Ta
闷	Nc
挤	Jw
零	Mi
腰	Nq
匹	Ca
抢	Ji
哀	Po
址	Fz
孤	Dm
胸	Ns
挑	Jk
哼	Ou
链	Ll
吐	Of
夹	Dk
纳	Si
炮	WsC_
珍	Ei
惠	Fb
冬	Wk
倘	Im
嫁	Xa
帽	Mb
钧	Ls_d
羊	Ey
姚	Xk
荒	Hu
韵	Ys_d
桂	Gf
伴	Ik
爬	Mc
炸	Wp
醉	Qu
聊	Hg
屏	Pk
框	Gc
牲	Fr
饿	<j
铜	Ln
骗	Mp
汇	Vc
疯	Rn
吵	Ov
绪	Sz
曹	Co
衫	Pv
卡	Yf
井	Hj
剑	Am
欠	<q
慈	KsC_
糟	Kc
逢	We
震	Mr
崇	Wa
宿	Ai
泉	Bk
廊	Rr
牵	Da
焦	Et
脆	N>
抹	Jg
饼	<k
宅	Ar
赋	Ml
悦	Yk
刷	Pm
贺	Wm
牢	Af
叉	XcA_
屠	Pz
忌	Cc
寓	An
趟	Zm
踪	Za
咽	Oq
萝	Hq
祁	Pp
纱	Sv
污	Vg
哎	Oh
楣	Gp
署	Qz
齿	Zi
燃	Wd
匪	Ce
践	Zt
敷	M>
喘	Ow
躬	Sg
锋	Lw
械	Gl
卢	Yp
腻	Nl
砖	Tg
遵	Kj
坊	F>
廷	Ez
锐	Lk
购	MsV_
怔	Yt
踢	Zb
俱	Iq
岭	Wi
蛙	Cf
宰	Au
衙	Do
踌	Ze
谭	Uq
荆	Hh
芽	Hc
姜	Ex
灶	Wf
囚	Qi
颐	Ct
朦	Nz
炒	Wv
嘟	Oz
履	Pd
瑜	Ea
爪	MzA_
诈	Up
轩	Lf
坝	Fm
狄	Dw
瞅	Qt
迦	Wz
巍	Wx
曳	Bx
螃	Cu
蝉	Ck
盹	Ql
邵	<p
蛛	Cg
彷	D>
蛐	Cq
巳	Cs
忒	LcT_
趾	ZzZ_
趾	Zz
蜘	Cd
膳	Ne
癫	Ra
忖	Yj
蜒	Cz
瞩	Qp
妍	Xt
饵	<h
翳	Cn
埂	Fx
骠	Mq
娅	Xw
砧	Ty
绀	Sh
圪	Fi
面	TqG_
理	EbF_
开	Th_d
便	IxB_
头	Kt_r
并	KhB_
此	ZlC_
相	GqX_
性	YrE_
眼	Qr_t
计	Uy_f
件	If_f
月	NyE_
候	IyD_
统	Su
程	ToE_
名	No_v
语	Ue_w
住	IuE_
做	IyW_
息	RqC_
位	IuW_
似	Iv_e
且	QqE_
接	Ju
言	Uy_b
类	Kd_s
报	JpX_
今	Iv_f
脸	Na_v
感	LoC_
坐	IiF_
句	So_f
命	Ao_q
快	Yd_d
望	UnE_
直	YqZ_
往	DuE_
求	Ku
海	ViB_
倒	If_g
识	UoA_
任	IeR_
远	GaZ_
带	Ma_v
每	Ib_v
半	KfB_
传	IgS_
示	Ss_e
空	A>_d
型	ThF_
孩	Du_e
马	MmA_
切	L>Q_
网	NxX_
反	RxF_
找	JlZ_
王	EwG_
虽	OcS_
喜	Fo_w
诗	Uf_f
利	Th_s
序	Rs_f
流	Vu
谈	UwW_
决	Kd_f
青	EnQ_
请	Ue_b
拿	Ao_f
早	ByZ_
认	UiR_
送	KdZ_
标	GsB_
艺	Hz_t
业	WyE_
谁	UeS_
站	Uy_w
读	Uy_d
客	Aw_w
值	IyQ_
热	JzT_
极	Gs_f
调	UnF_
态	DuC_
六	Ul_r
让	UyT_
复	IbW_
曾	KbB_
建	EfZ_
收	YwS_
万	<w_b
画	Tb_r
运	Gz_t
战	Yo_s
军	Al_f
规	DnA_
晚	B>A_
答	Ka_w
朋	Nn_q
吗	Om_v
失	Ds_e
饭	<rX_
假	IfX_
愿	RbC_
较	Lu
布	RmB_
男	B>_b
城	Fl_f
片	Kp_b
敢	VhW_
病	Rt_e
火	Wh_w
静	En_f
越	Zl_s
忙	Yu
例	Id_g
政	TzW_
造	FoZ_
段	EnD_
木	Gm_r
娘	XuR_
整	GwZ_
格	Gw_w
哥	JjG_
慢	YbX_
确	T>_v
精	Ke_b
呀	Oc_f
紧	HxV_
拉	Ju_s
夜	UiW_
简	KnB_
述	GuZ_
旧	Yb_f
观	XnA_
校	GuX_
华	Il_t
云	Gy_b
展	Ph_q
初	P>C_
概	GrA_
刚	Nx_g
船	Dn_w
断	KlR_
环	Eg_g
弟	KgR_
刻	Ui_g
选	FaZ_
终	Sw_d
姑	XyG_
注	VuE_
专	GsZ_
妇	XeF_
穿	Ac_f
达	DzD_
达	Dz
诉	Ur_r
洋	Ve_t
香	TbX_
笔	Ke_s
汉	Vx_g
角	<m_f
咱	OrQ_
印	Ep_t
装	Kf_q
馆	<aC_
软	L>R_
领	Is_v
资	K>_v
睡	Qe_g
既	RcA_
剧	Py_g
阿	PjA_
般	DnB_
阳	Pb_t
玩	EgA_
首	Ks_r
操	JoG_
议	Ux_r
译	UxF_
睛	Qe_b
版	KrX_
痛	Rs_v
试	Ul_a
楼	GkX_
级	Ss_f
待	Df_f
效	UxW_
众	Ii_e
岁	WnS_
验	Ma_v
验	Ma
验	MaM_
春	DbC_
急	<eC_
窗	AbC_
怪	YxF_
竟	Ya_f
佛	Ig_g
革	<gE_
依	Ip_t
状	Kd_r
散	HnW_
您	I>C_
背	Kl_b
码	Tm_v
唱	ObB_
纸	Sc_s
检	Ga_v
演	VaB_
密	AcW_
短	Id_d
析	GrX_
况	KoA_
属	PnC_
仿	I>F_
板	GrX_
板	Gr
板	GrG_
端	UwQ_
考	YrS_
茶	HiG_
堂	MfT_
阵	PlZ_
顺	Mt_v
绝	S>C_
忘	UlC_
顾	Rc_v
灯	WjD_
某	HtG_
歌	Jj_a
区	CxQ_
卖	Yv
沉	Va_b
喝	ObS_
兵	RtA_
商	UsG_
质	Ry_v
率	Uk_t
讨	UjT_
亮	Ua_b
跳	Zk_d
梦	Gg_b
钟	Lo_t
略	Bw_w
帮	Ep_v
宝	Ae_r
礼	Pl_s
害	Ae_w
含	Iv_w
街	Df_f
街	Df
街	DfD_
惊	YuV_
坏	Fg_g
权	GxQ_
创	Ic_g
曲	QhQ_
曲	Qh
域	FlT_
价	Ii_g
游	V>D_
爸	XcB_
凤	NxF_
限	PrX_
派	Vr_q
献	MkD_
排	Je_q
纪	Sc_f
哭	OoD_
否	GoF_
福	PtB_
测	Vm_g
卷	KdC_
翻	Rb_f
免	<oA_
充	UvA_
桌	YbG_
按	JaX_
刘	Wh_s
围	Qg_q
止	Zz_e
婚	XcB_
婚	Xc
婚	XcX_
队	PiD_
暗	ByA_
珠	EgZ_
辑	Lo_g
克	Ya_d
默	Qd_r
甚	HlS_
评	Uf_d
仍	IsR_
预	Sj_v
修	IyV_
掉	Jy_t
司	Jt_w
朝	Yy_b
归	HeG_
范	HvC_
划	Lh_g
斯	HrS_
灵	Ew_s
导	CjD_
函	Vk_r
杀	XgS_
泪	Vq_s
束	GoS_
亦	Uw_t
突	Ad_r
居	Py_f
执	Jz_r
招	J>Z_
载	Yl_s
靠	FoE_
血	RqX_
齐	WhQ_
仅	Ix_f
阶	Pi_g
床	RgC_
良	Ur_s
封	Ff_f
疑	LdZ_
呼	Or_f
伤	Ii_a
停	Iu_f
伯	IbB_
星	BrE_
宣	AtT_
养	Eu_g
负	<mF_
草	Hb_t
左	R>Z_
势	Jz_a
亚	WyA_
抗	Ju_b
党	MaD_
冲	Ko_t
遇	BnZ_
仁	IgR_
护	Jp_g
幸	FkF_
幸	Fk
著	HzZ_
善	Ek_w
速	GoZ_
介	Ih_f
育	Uv_b
芳	H>F_
省	VqS_
误	UoD_
激	V>W_
斗	Kd_r
斗	Kd
斗	KdK_
室	AtF_
瑞	EwQ_
鼓	FkX_
晓	BlA_
帝	Ua_v
绿	Se_d
骂	Oo_v
唐	Re_w
曰	ByE_
架	Wg_f
缺	Fu
富	AtB_
叶	Oy_t
绍	S>S_
绍	S>
忍	<uC_
案	AxG_
嫂	XeX_
嫂	Xe
哈	Oa_w
铁	LdT_
舞	InF_
州	MmZ_
材	GjC_
牛	Fn_r
肉	IiR_
松	GaV_
店	Ry_w
座	RiF_
抽	JbC_
洗	VfA_
恨	Yr_g
沙	VvS_
佩	In_v
楚	GgZ_
姓	XrE_
移	Tn_b
淑	VvX_
怀	Yg_g
兄	OaX_
批	Jl_q
墙	FfQ_
雪	MeX_
符	Ki_f
麻	RgG_
敌	YwD_
喊	Ol_w
波	VpX_
枪	GiC_
借	IhB_
童	UbF_
策	Kg_b
村	GjC_
村	Gj
村	GjG_
田	Bt_b
罪	QeZ_
威	LtX_
济	Vw_g
婆	VpX_
婆	Vp
婆	VpV_
叔	YvX_
射	SjS_
射	Sj
藏	HlC_
翠	Ju_t
圆	Qo_v
孔	Dl_d
油	Vb_t
智	IoB_
副	Tb_g
退	RzT_
野	Bf_f
伸	Ib_t
承	Vv_d
荣	ZgR_
择	JxF_
凡	NuF_
均	Fs_d
劳	Z>_s
龙	XlG_
置	QyQ_
置	Qy
湖	Vy_b
虑	Pc_s
牌	Kb_e
挂	JfF_
烧	WlA_
救	KuW_
丈	Xz
典	QhA_
刺	Gn_g
偏	IpQ_
烈	DhT_
眉	Pq_v
释	RkF_
课	UbG_
阴	Pn_t
丝	SsT_
询	UsB_
拜	JtE_
赞	Ff_v
括	Jy_d
隐	P>C_
隐	P>
隐	P>P_
获	HdD_
迅	ZyZ_
迅	Zy
叹	OxT_
虎	Pn_g
穷	A>Q_
顿	Lu_v
厂	RcG_
追	RcZ_
隔	Pt_b
扩	Jr_d
雄	RvE_
沈	Vm_s
庭	ReZ_
班	EhE_
班	Eh
伟	Ig_q
尤	Zu_t
丰	EfG_
委	TxW_
织	SoA_
摸	Jm_w
夏	TqW_
慧	EeC_
混	Vb_s
探	JaG_
弱	GkG_
弱	Gk
末	Gm_w
减	Kl_w
勇	Sm_a
拟	Jv_e
柔	SjG_
芬	Ha_a
遍	PqZ_
逃	KkZ_
临	HkB_
登	At_d
宗	AsZ_
闭	NjB_
险	Pa_v
递	KgZ_
毫	Ua_s
惯	Yb_v
诸	UzZ_
针	LyZ_
凉	KuV_
占	YoZ_
担	JbT_
摘	JuZ_
寄	Ad_f
逻	QnZ_
伙	Iw_g
律	DeF_
积	ToA_
击	Fu_f
缘	SeA_
插	JfE_
雅	CjE_
份	Ia_a
欲	W>_t
补	PyB_
矩	IdC_
冰	KkB_
腿	NrZ_
药	HsS_
庄	RfZ_
柳	Gg_q
诚	Ul_f
困	Qg_d
惜	YhB_
彩	MgV_
吾	EoW_
席	Rh_v
亡	UlW_
竹	Kz_r
妻	YeX_
轮	Li
授	J>X_
灭	Tw_v
碰	TkW_
础	Tw_r
朵	NgD_
折	JrZ_
附	Pi_f
劝	X>Q_
握	JpF_
拍	Jb_q
吸	OsX_
稿	Tu
益	KaQ_
弹	Gk_t
骨	Ag_r
杯	GgB_
缩	SaB_
坚	HxF_
判	Kf_g
横	GhA_
呆	OgD_
莲	HlZ_
呵	Oj_g
储	IuZ_
旅	<i_q
防	P>F_
愁	TwC_
私	TvS_
皆	Lb_f
鸡	Xs_f
遗	CmZ_
透	TsZ_
颜	Uv_v
恋	UwC_
施	<iC_
寂	AvX_
圣	XfS_
营	Zo_w
晨	Br_q
宋	AgS_
鼻	Rq_g
票	Qs_q
牙	Cj_t
鸿	V>S_
怒	XxC_
妙	Xv_v
劲	X>_a
氏	ClS_
欧	Cx_a
训	UmX_
辛	Ux_b
蓝	HkQ_
康	Re_d
椅	Gd_f
浪	VuR_
稍	Tm_b
忠	OyC_
枝	GyX_
忆	Yz_t
矣	ViD_
荪	HdV_
迟	RzC_
陶	PsF_
鲜	<eX_
瞧	QeT_
卫	PtW_
财	MjC_
串	Oo_t
缓	SmX_
抓	JmZ_
货	Il_v
厅	RjT_
愈	AhC_
辈	ElB_
猫	DhB_
健	IeZ_
洞	VnT_
付	IjF_
壁	PuF_
厚	RbD_
尖	Vd_f
陪	Pu_w
匆	Sd_r
扬	JjD_
慰	PjC_
旗	<i_g
途	ItZ_
赏	MmS_
寒	Ah_d
搬	Jd_b
净	K>_f
姊	XsR_
梁	V>G_
迹	UwZ_
秦	DtQ_
偶	Ib_b
薄	Hv_f
厌	Rd_r
辞	YuC_
尊	Kq_f
躺	SmT_
狂	De_d
纯	Sl_r
禁	GgS_
奋	DbF_
镜	LyA_
甫	Mf_r
休	IgX_
桥	Gr_g
俩	It_e
幅	MtB_
监	HkQ_
监	Hk
监	HkH_
悄	Ym_b
碎	Tu_t
股	NnG_
孟	Dq_v
仙	IwX_
犯	DcF_
攻	<wG_
粉	Ka_a
猜	De_b
迫	Bz_q
汗	Vf_g
延	RzZ_
幕	Mo_v
坡	FpX_
仲	Io_t
聚	Hx_d
岸	WrF_
寿	EjS_
振	Jr_q
凭	Ie_b
肩	Pn_f
触	<mC_
危	<rC_
胆	NbT_
厉	R>_s
努	Xx_a
舒	Ay_f
球	Ek_r
宁	Aj_b
恰	Ya_w
昏	Cl_g
鸟	Sn_w
搜	JeX_
擦	JaS_
戴	YlA_
扫	JeS_
盛	LjQ_
荷	Hi_f
详	UeX_
剩	Tk_g
颇	Px_v
镇	LyA_
镇	Ly
镇	LyL_
洲	Vm_v
累	BsV_
抵	Jc_r
启	PoQ_
逐	AzZ_
仰	Ic_q
潮	Vy_b
潮	Vy
潮	VyV_
乘	Tk_s
胖	NkF_
峰	WwE_
邻	Is_q
敏	IbW_
敏	Ib
敏	IbI_
壮	KfZ_
残	Dt_s
尺	Rc_e
舅	Eb_a
粗	KqC_
涂	ViT_
升	RhS_
愤	Yy_v
肚	NfD_
降	PwF_
循	DrQ_
拾	Ja_w
冯	KmF_
魂	GbA_
幽	SsW_
岂	WcQ_
稳	T>C_
洁	Vf_w
尾	Pe_s
沿	Vn_w
躲	SnG_
扑	Jy_q
贴	My_w
冒	Bq_v
番	RkB_
尝	MgC_
陆	Pf_r
墨	Qf_v
弃	Uv_g
徒	DzT_
巡	MzX_
拥	Jm_t
赖	Go_v
箱	KgQ_
川	Mc_b
浮	VmD_
废	RwF_
吓	OfX_
忧	Yz_r
猛	DdQ_
播	JrB_
挥	Ja_s
祝	PoA_
鸣	Os_v
塞	AhF_
瘦	ReX_
聪	HkC_
漫	VbX_
赤	FwC_
辩	Uu_r
奔	Dy_g
亭	Ua_f
挨	JvD_
泥	Vp_s
咬	OuX_
仆	Iy_q
拼	Jk_g
挺	JeZ_
逼	TbZ_
挣	J>_f
核	Gu_e
迁	FzQ_
斜	It_d
屈	Pw_r
泛	VrZ_
距	Zc_q
销	Lm_b
扯	JzC_
吉	Fo_f
庙	Rb_v
岛	SwD_
卿	Gr_q
阔	Nv_t
磨	RgT_
唇	Rp_w
怨	NcC_
障	PyZ_
慌	YhA_
耐	Tq_f
浅	Vt_s
涉	VzD_
暂	LrB_
添	VtV_
添	Vt
宫	Ao_w
款	Fs_a
瓶	KhW_
垂	EhC_
吟	OiV_
毒	EbD_
唤	O>D_
乔	Rd_g
蒙	ZgA_
仗	IxZ_
冠	Aa_f
繁	IwV_
俄	Ij_s
惨	YvV_
荡	Hv_f
荡	Hv
荡	HvH_
哲	Jr_w
脾	Nb_e
桢	Gy_v
杜	GfD_
婉	XaC_
乙	Zy_e
犹	Dz_r
烂	WkV_
谋	UhG_
滑	Va_b
滑	Va
滑	VaV_
溜	V>B_
企	IzQ_
弯	UwG_
玻	EpX_
飘	Qs_b
欣	R>X_
锁	Lm_v
纷	Sa_a
津	VeF_
璃	Ew_b
滚	VpV_
滚	Vp
滚	Vp_p
皱	<eX_
皱	<e
皱	<e<_
佳	IfF_
伏	Id_r
绕	SlA_
懒	Yg_v
埋	FbF_
埋	Fb
勉	<a_a
巨	Cp_f
雷	Mb_s
伦	Ii_s
仇	IzC_
剪	Kh_a
泰	DkT_
陷	P>E_
殊	DgS_
惟	YeW_
竞	UoA_
竞	Uo
竞	UoU_
臂	Pu_b
帐	MkT_
郑	Kd_q
纵	Si_e
割	Ao_g
丧	Fk_q
凑	KdD_
嚷	Op_g
驱	McX_
捉	JzZ_
扎	JlZ_
扎	Jl
扎	JlJ_
掩	Jd_s
卜	Yb_r
幼	S>_t
乌	Sw_r
乏	RzF_
摩	Rg_f
貌	DbA_
暖	BmX_
览	HkA_
旋	<iZ_
翁	Av_f
讯	Uz_t
丛	IiT_
籍	KgB_
尼	Pl_b
奴	Xx_b
搭	Jh_w
桃	Gk_d
饰	<i_v
孝	YrD_
返	RxZ_
拖	JiC_
蛋	VzC_
润	VnE_
欺	H>Q_
嫌	XkW_
朗	Ur_b
毁	E>_b
睁	Q>_f
敲	UyX_
申	ByS_
扇	PjS_
漂	VqS_
漂	Vq
漂	VqV_
慕	MoV_
悔	YiB_
傅	Im_f
伊	IeR_
伊	Ie
伊	IeI_
旦	BtD_
紫	ZlV_
塔	Fh_w
虫	CcG_
浓	Va_q
绘	SiG_
侧	Im_g
租	TqZ_
郎	Ur_q
阻	PqZ_
阻	Pq
阻	PqP_
牺	FqX_
扶	JdF_
综	SaS_
综	Sa
培	Fu_w
倾	Il_v
倾	Il
倾	IlI_
羞	EbX_
幻	Sj_g
恼	Yw_r
删	Nt_g
媳	XrC_
亏	Gs_d
扭	Jb_b
促	IzC_
促	Iz
促	IzI_
狱	DuD_
狱	Du
季	Td_f
损	Jo_v
霞	MfX_
臣	Cc_b
傻	IbW_
厨	Rk_f
捧	JdF_
捧	Jd
捧	JdJ_
仪	Ix_r
泼	Vw_q
辆	Lt_e
柜	Gc_q
袖	PbX_
颗	Bg_v
茫	Hv_s
甜	YhT_
苍	HiC_
兼	KeW_
筑	K>_b
豆	To_d
颤	Ut_v
焉	TsT_
焉	Ts
账	MkT_
账	Mk
账	MkM_
抖	JkD_
奉	DfF_
寸	Jc_b
丹	NuD_
瓜	MgA_
估	IyG_
侵	IeX_
盆	A>Q_
盆	A>
盆	A>A_
阅	NkA_
杰	Gt_f
戚	LyV_
酸	QvW_
玛	Em_v
赐	MbS_
袍	PsC_
戒	Lh_f
衡	Dd_f
肃	EqS_
肥	NcF_
宇	At_f
窝	Ao_e
妨	X>F_
恢	YrW_
允	Va_t
缝	SwZ_
渡	VrX_
予	Sj_t
夺	DjD_
夺	Dj
昭	B>Z_
央	DyG_
卧	CyW_
丑	Bc_r
尘	VfC_
贞	YmZ_
档	GmE_
染	VzG_
踏	ZkB_
贝	Mb_e
扮	Ja_a
傲	IaA_
谣	Um_r
糖	Kr_w
绅	Sb_t
遭	CoZ_
歇	Bs_a
湿	VbW_
港	VhC_
鹏	NnS_
拳	Kd_f
拳	Kd
拳	Kd_d
捕	JmB_
爹	Xn_b
勤	He_a
恭	HaV_
搁	Jn_w
裁	Yl_q
洪	VhA_
臭	RqD_
汤	VjD_
贫	A>_v
斋	WtQ_
疏	VzA_
叙	ItX_
雾	Mw_a
汪	VeW_
郁	Rn_q
督	YxQ_
拒	Jc_q
纹	SwW_
倍	Iu_w
豪	UaA_
笼	Kx_s
倦	IkC_
寞	Am_w
掏	JsF_
截	YlE_
钻	Ly_w
栏	GkV_
凝	KdZ_
哟	OsS_
悟	Ye_w
瓦	WwA_
娶	HxX_
裳	MpS_
稀	Tx_v
裤	Pr_s
绸	SnF_
恩	QdC_
叠	XxQ_
坛	FgT_
滴	VuD_
餐	YxR_
甘	HtG_
甘	Ht
甘	HtH_
吞	Td_w
拦	JkV_
夸	DgS_
夸	Dg
夸	DgD_
辱	Rp_f
柱	GuE_
炉	Wp_s
盾	RyQ_
悉	RkC_
讽	UnX_
杭	Gu_b
贤	Hx_v
盼	Qa_a
涌	Vs_v
爽	DxX_
唉	OvD_
娜	Xn_q
妥	MxT_
谷	Wg_r
芝	HzZ_
芝	Hz
芝	HzH_
疲	RpX_
奸	Xf_f
蕙	HfC_
牧	Fw_v
扣	Jo_d
催	IwE_
粮	KuR_
桐	GnT_
疼	Rw_d
钉	LjD_
邮	Bp_t
膀	Nu_a
鉴	Hk_s
阁	Nw_w
嘻	Of_w
寺	FjS_
骤	Mx_d
昌	BbC_
腾	Nk_v
遮	RtZ_
蜜	AcC_
册	NnT_
娃	XfF_
堪	Fh_s
趋	Z>E_
额	Ao_v
覆	QdW_
吊	OmD_
沟	VsV_
沟	Vs
岳	RtW_
骑	Md_f
譬	Pu_r
拔	JwB_
吕	Oo_s
翼	JbA_
耻	HzC_
脖	NyD_
订	UjD_
签	Ka_v
仔	IdZ_
跃	ZrD_
惹	HrC_
凄	KyX_
溪	VmD_
溪	Vm
溪	VmV_
伍	IeW_
舌	YsE_
棉	Gb_v
辉	Ma_s
嵌	Wh_a
尸	Ps_e
惑	LtC_
邦	EpB_
狠	Dr_g
腐	Rj_e
审	Ab_t
嘛	OrG_
娇	Xr_g
猪	DzZ_
腔	Na_a
矮	IdX_
扔	JsR_
扰	Jz_r
扰	Jz
扰	JzJ_
撞	JuF_
碍	Tb_f
董	HeB_
歪	GtZ_
菊	Hs_d
磁	TkS_
抄	JvC_
愧	YbA_
挽	J>A_
盒	AoQ_
饮	<>_t
坦	FbT_
饱	<sC_
捏	JbF_
谅	UuV_
吻	OsD_
愉	Ya_g
艳	E>C_
痕	Rr_g
冤	Aa_r
妞	Xb_b
债	Ie_v
隆	PwE_
柴	ZlG_
慎	YyA_
耍	TqX_
彻	Dl_a
慨	YrA_
赌	MzD_
壶	FaW_
坟	FwF_
坟	Fw
粒	Ku_s
朴	Gy_q
咐	Oi_f
矛	Sj_v
矛	Sj
矛	Sj_j
脏	NrF_
融	TnC_
玲	EiS_
伪	I>_d
铃	LiS_
撒	JnW_
瞎	Qa_w
辨	Uh_r
萧	HeQ_
浙	VjR_
悬	QvC_
巾	Mj_b
帘	Am_s
奖	KnD_
衍	Dv_f
航	Du_b
袁	Fo_q
碧	EbT_
轰	LxX_
挖	JaZ_
谦	UkW_
愚	BnC_
莱	Hg_d
咳	Ou_e
植	GyQ_
遥	Mu
嘉	FoW_
钢	LnX_
梯	GkG_
梯	Gk
梯	Gk_k
夭	Rd_t
轿	Lr_g
赛	Ah_v
抛	Jz_a
抛	Jz
抛	Jz_z
剥	Ek_g
栗	Qg_s
哩	ObF_
漆	Vg_d
姿	K>X_
崔	WeC_
巷	HaC_
填	FyA_
揭	JbS_
凶	XuX_
凶	Xu
呜	OsW_
祸	Po_e
鸭	Bs_t
洒	VqS_
洒	Vq
洒	Vq_q
衰	PoT_
梳	GuA_
爆	Wb_d
酬	Qm_v
晴	Be_b
匠	Cr_f
罚	Qu_g
披	JpX_
披	Jp
披	JpJ_
逸	<aZ_
悠	IwC_
腊	NhB_
隶	Ek_s
斤	Rj_b
丫	Ky_t
锦	Lb_v
哄	OhA_
摊	JxE_
池	VcC_
兽	Kb_w
韩	Yy_q
卑	BiB_
卑	Bi
励	R>_a
晃	BmA_
敦	UdW_
枯	Gy_d
殿	Pa_b
郭	Ud_q
奈	Ds_b
绩	Se_v
遂	KaZ_
抚	Jf_s
廉	RkW_
浑	Va_s
袭	XpX_
袭	Xp
缠	SrF_
绣	StS_
绣	St
蓬	HwZ_
嘲	Oy_b
鼠	EkS_
拓	JtT_
虹	C>_g
裂	Dh_q
魔	RgA_
煤	WhG_
渊	Vh_d
耶	Hp_t
疾	RiD_
盗	K>Q_
凳	At_b
恳	Rc_d
寡	At_a
胞	NsC_
灾	AwZ_
蛇	Ca_s
泽	VxF_
鹤	AeS_
倡	IbB_
枕	Gm_s
艰	Xr_f
拨	JwB_
拨	Jw
拨	JwJ_
夕	Nx_e
骄	Mr_g
抑	Jc_q
抑	Jc
抑	JcJ_
喷	Oy_v
玄	UsX_
呈	OeC_
旺	BeW_
佟	Iw_d
贼	MlR_
萨	HpR_
墓	MoF_
谎	UhA_
雕	NfE_
逆	KwZ_
瞪	Qa_d
凌	KfW_
宏	ArV_
眠	Qc_s
棵	GbG_
棵	Gb
筋	Kn_a
湾	VuG_
耀	MaE_
俊	IvW_
拘	Js_w
狼	DuR_
艾	HxA_
宾	ArT_
雇	PeG_
搞	JuG_
龄	ZuS_
患	OoC_
罩	Qy_t
劣	V>_s
姻	XqD_
撑	Jm_f
召	<z_w
诱	UtS_
妓	XyX_
妓	Xy
辅	LmF_
誉	Mu_t
帧	My_v
倚	Id_f
谊	UaQ_
暑	BzS_
凯	Wc_b
钥	Ln_t
哉	Yl_w
勃	Yd_a
拆	Jr_r
伺	IjT_
纠	Sy_f
阀	Ni_s
跪	Z>C_
侍	If_f
侍	If
侍	IfI_
刑	Th_g
侯	IpD_
贪	Iv_v
晕	Ba_s
鞭	<iX_
裕	Pw_t
掘	Jp_r
弦	GuS_
膝	Nd_d
涨	Vg_d
涨	Vg
涨	VgV_
谨	UhE_
奏	DrD_
奏	Dr
摔	Ju_t
摔	Ju
摔	JuJ_
昂	Bc_q
渴	VbS_
耗	Ge_s
筒	KnT_
苗	Hb_v
辣	Ug_w
赴	ZyF_
骚	MxC_
廓	Rd_q
驳	MxX_
痴	Rd_w
肠	NjD_
顽	Ga_v
顽	Ga
顽	GaG_
棚	Gn_b
嘱	Op_b
诺	Uh_w
勒	<>_s
秃	TnT_
秃	Tn
湘	VgQ_
颈	X>_v
怯	YfV_
漠	Vm_w
楞	Gq_a
兮	AsX_
惧	YqA_
锅	Lo_e
喂	Ob_q
侮	IiB_
潜	VdB_
绳	So_s
跨	ZdS_
绒	SlR_
炎	Ww_t
森	GgG_
森	Gg
庸	Re_v
辫	Us_r
裙	Pe_w
迭	DzD_
迭	Dz
迭	Dz_z
陵	PfW_
颂	Av_v
跌	ZdD_
贡	<mG_
贾	Qm_f
舟	Dz_r
诵	Us_v
滋	VkS_
仓	IcC_
蹲	Zk_f
泡	VsC_
泄	VlX_
惶	YbE_
珊	EnT_
夷	Dg_t
庞	Rx_q
措	JhB_
缎	Se_b
豫	SjA_
捐	Jo_b
趁	ZiV_
邀	BwZ_
贯	BmG_
押	Jb_t
杆	GfG_
杆	Gf
斥	RuC_
蛮	UwC_
蛮	Uw
蛮	UwU_
勾	SvG_
袜	PgW_
鸦	CjS_
棺	GaC_
憎	YkB_
咒	Oo_b
役	Dn_t
婶	Xa_t
谱	UkB_
碑	Tb_e
宪	AfA_
宪	Af
削	Mn_g
洛	Vw_w
赔	Mu_w
喉	OiD_
辰	RpC_
诊	UiV_
饥	<n_f
颠	Ya_v
漏	Vp_v
儒	ImQ_
媚	XpQ_
拚	Jv_g
藤	Hn_d
矢	IdS_
咕	OyG_
烛	WcZ_
磕	TfQ_
歉	Kw_a
遣	CcZ_
藻	HvG_
惭	YlR_
汝	VxR_
筹	Ke_f
蔡	HaS_
膊	Nm_f
褂	Pf_t
贱	Mt_s
滩	VxE_
羡	Ek_a
匀	Sk_t
宙	AbZ_
橘	Gs_b
乳	Md_s
嗓	OxG_
耽	Hm_s
巫	<i_e
竖	Hx_r
刮	YhG_
滨	VaR_
雀	VeQ_
鄙	Oq_q
屁	Pl_q
稽	TzB_
熊	VlT_
浩	Vf_w
浩	Vf
浩	VfV_
哇	OfF_
麦	Ew_v
妒	XpD_
畅	By_f
侄	ItF_
傩	IxE_
箭	Kk_g
宴	AbX_
脉	Nu_d
堡	IoF_
噢	ObD_
樊	GgD_
魏	TxA_
畏	BpW_
棍	Gb_s
壳	Fa_b
胳	Nw_w
胳	Nw
胳	NwN_
冻	KlV_
帕	Mb_q
裹	PbG_
蠢	DcC_
荫	Hp_b
炼	WlV_
挡	JmE_
薇	HdW_
羽	Jy_r
怖	Yr_v
翰	Yy_f
侠	Id_d
侠	Id
侠	IdI_
弥	G>V_
蒋	Hk_f
钞	LvC_
狭	Dd_d
霜	MgQ_
晌	Bb_w
乾	YyZ_
逝	JrZ_
逝	Jr
逝	JrJ_
辟	Po_r
堵	FzD_
粹	Ku_t
昔	HbX_
衬	PjC_
衬	Pj
衬	PjP_
株	GgZ_
株	Gg
株	Gg_g
祭	As_f
浏	Vw_g
浏	Vw
浏	VwV_
陀	Pa_s
玖	E>_r
援	JmX_
莺	Zs_t
嗽	Og_a
槐	GbA_
槐	Gb
槐	Gb_b
窄	ApZ_
绮	Sd_f
锣	Lq_b
兔	<a_r
恂	YsB_
猴	DiD_
猴	Di
樱	GmX_
沫	Vg_v
佣	Im_t
晶	BbB_
晶	Bb
酷	Qf_w
晋	Wb_f
柏	GbB_
晒	BqS_
蜂	CwE_
葬	Hl_g
瞒	Qh_e
逛	DeZ_
稚	TeZ_
掷	Jd_q
涛	Ve_f
佑	Ir_w
笛	KbD_
嫩	XgW_
驾	Wm_f
舱	DiC_
亿	Iz_t
滤	VpC_
瑰	EbA_
嗯	OqC_
粘	Ky_w
鞠	<s_d
躁	ZoG_
噪	OoG_
昆	Bl_d
棒	GdF_
捷	JtZ_
霓	MeA_
厢	RgQ_
喻	Oa_g
翅	Yx_f
葛	Hs_e
茅	Hs_f
哑	Ow_t
嗳	O>X_
剖	Uo_g
售	EoS_
淘	VsF_
玫	Ew_v
玫	Ew
玫	EwE_
逗	TkZ_
劫	Fv_a
笨	KgT_
戈	LgE_
俯	Ir_f
扁	PqB_
颓	Tn_v
驻	MuE_
筷	KyD_
惘	Yn_d
薪	HqR_
啼	Ou_v
旨	LbZ_
赚	MkW_
簇	K>D_
霸	M>_b
筝	K>_f
筝	K>
筝	K>K_
堕	PrF_
泊	VbB_
赠	MkB_
襟	PgS_
捣	JsW_
竭	UbS_
钩	LsV_
肤	NdF_
乖	Fk_s
篮	KkQ_
罐	FuE_
渺	VqV_
撕	JhR_
凸	Tt_r
浴	Vw_t
恒	YtT_
携	JeS_
携	Je
携	JeJ_
嚼	Om_f
拢	Jx_s
违	GpZ_
驰	McC_
蕴	HsQ_
兜	CpA_
灌	VhE_
恕	XoC_
蝎	CbS_
俏	Im_b
瞥	KwQ_
踱	ZrX_
暮	MoB_
揉	JsG_
屑	Pm_b
咖	Ow_d
讶	Uc_f
岩	Wt_t
吩	Oa_a
琐	Em_v
琐	Em
琐	EmE_
缀	SxX_
吏	Xo_s
涵	Vv_r
歧	ZyX_
焰	W>E_
赢	Um_t
盟	BnQ_
掀	Jr_a
糕	KeT_
殷	Pj_b
脊	Kk_b
税	TkA_
拐	JwG_
撤	JnW_
撤	Jn
撤	JnJ_
苟	Hs_w
芦	Hp_s
矿	Tr_d
饶	<lA_
闯	NmC_
叨	O>D_
叨	O>
叨	O>O_
盏	TlQ_
侦	Iy_v
妆	KxZ_
啡	OeF_
敛	AmW_
郊	Ux_q
倩	Ie_b
倩	Ie
倩	Ie_e
鸽	AoS_
妖	XrD_
娥	Xj_s
刹	Xg_g
纤	SfX_
屡	PkX_
蔽	HmW_
桩	GrF_
乞	IzQ_
乞	Iz
乞	Iz_z
弊	Kw_g
痒	Re_t
桶	Gs_v
胃	BnW_
迈	<z_v
棋	GhQ_
赫	FwW_
澡	VoG_
奥	BkD_
僵	ItT_
勿	SdW_
脂	NlB_
姆	Xb_v
咧	On_g
桑	XxG_
娱	XoD_
衔	Dl_f
拣	JlV_
亩	Ub_v
冗	AnR_
帖	My_w
帖	My
帖	MyM_
驴	Mp_s
邪	Cj_q
盐	FyQ_
淋	VgG_
璐	Ez_w
盲	UlQ_
煮	ZtZ_
煮	Zt
栈	Gt_s
蝶	ClG_
撰	JcA_
铨	LiE_
拱	JhA_
莉	Ht_g
窘	Ae_w
窘	Ae
窘	AeA_
颊	Dk_v
灿	WwC_
蓄	HuB_
誓	Jr_r
掠	JuV_
娴	XnG_
伐	IlF_
恍	YmA_
碌	Te_d
埃	FvD_
窃	Al_a
沾	Vy_w
浸	VeX_
菲	HeF_
烘	WhA_
菱	HfW_
陌	PtB_
陌	Pt
陌	PtP_
哗	Ol_t
莎	HvV_
丘	RtQ_
搀	J>_d
叛	KfX_
梢	Gm_b
呕	OcX_
匣	CbX_
囊	Yo_q
禅	Pk_t
秒	Tv_v
泣	VuQ_
御	Dz_q
斑	EwE_
斑	Ew
斑	Ew_w
溢	VkQ_
轨	LzG_
绵	Sb_v
坑	Fu_b
棠	MgT_
柄	Gt_e
碟	TlG_
驼	Ma_s
驼	Ma
驼	Ma_a
裸	PbG_
裸	Pb
裸	PbP_
契	E>D_
唧	Or_q
秩	TdZ_
傍	Iu_a
腹	NiW_
摹	Mo_f
袄	PrD_
腕	NaC_
绢	So_b
摄	JhX_
挪	Jn_q
莽	Hd_g
徽	DvW_
偿	ImG_
岗	WnX_
妄	UlX_
撇	JmW_
陋	Pt_s
叮	OjD_
钦	L>Q_
钦	L>
钦	L>L_
坎	F>_d
菩	Hu_w
堤	FbZ_
蔑	Hl_r
诞	UrZ_
捡	Ja_v
谐	UlB_
黛	LqD_
蝇	Co_s
狮	Dh_v
钮	Lb_b
阈	NlT_
枉	GeW_
蹈	ZmE_
茵	HqD_
铭	Ln_w
姥	Xy_s
嫉	XrD_
嫉	Xr
嫉	XrX_
弧	Gm_g
廿	Hn_b
骆	Mw_w
僻	Io_r
庚	Re_e
喇	Og_g
诧	Ua_s
诧	Ua
诧	UaU_
炕	Wu
婴	MmX_
坠	PiF_
耸	Ii_g
耸	Ii
耸	IiI_
吼	Od_s
庵	Rd_s
斟	Hl_d
咸	Lt_w
婿	Xv_b
昧	Bg_v
昧	Bg
昧	BgB_
瑾	EhE_
瑾	Eh
瑾	Eh_h
兹	KsS_
肿	No_t
兆	KkZ_
兆	Kk
兆	KkK_
烫	VjW_
梨	ThG_
揩	JlB_
榻	Gb_f
枣	Gn_d
轴	LbZ_
轴	Lb
轴	LbL_
缸	Fu_a
蜡	ChB_
症	RtZ_
症	Rt
症	RtR_
瞻	Q>_r
匙	Bz_s
蚁	Cx_r
贩	MrX_
卒	Ui_t
胎	Nv_w
芸	Hg_t
伞	Ik_t
顷	Lt_v
搅	JmA_
苹	Hf_d
潘	VrB_
祷	Pe_f
鹅	JlS_
僧	IkB_
腮	NbC_
毅	Ua_b
毅	Ua
毅	Ua_a
擎	Hw_f
酱	KnQ_
歹	Dd_e
塘	Fr_w
攀	Gg_f
渔	V>_t
徊	Dq_w
猎	DhB_
猎	Dh
猎	DhD_
岔	A>W_
缚	Sm_f
舜	<nF_
圾	Fs_f
犬	DuQ_
垃	Fu_s
盈	SxQ_
锡	LbS_
殖	DyQ_
衷	Po_t
拂	Jg_g
狐	Dm_g
肺	Nt_v
僚	IdV_
喧	OaT_
篷	KwZ_
篷	Kw
篷	KwK_
劈	Pu_a
黯	QyA_
悼	Yy_t
垫	JzF_
砍	T>_d
叭	OaB_
嗡	Oa_f
伶	IiS_
诬	U>_e
涯	VrF_
浦	Vm_q
液	VuW_
躇	ZhZ_
躇	Zh
鹿	Rb_s
肝	NfG_
嘿	Oq_g
稻	TmE_
熬	AtA_
熬	At
萄	HsF_
讥	Un_f
驶	MoX_
簿	Kv_f
韦	GpW_
葡	Hs_v
瓷	K>W_
隙	PvV_
淫	VmE_
妮	Xp_s
穆	TbV_
毙	Ld_s
檐	G>_r
箫	KeQ_
揣	JwQ_
晰	BgR_
枚	Gw_v
硕	Tt_v
怅	YkT_
暇	BfX_
仑	Il_s
闺	NfF_
蒸	HvT_
杏	GoX_
讳	Ug_q
铅	Ln_w
铅	Ln
铅	LnL_
坪	Ff_d
蒂	Hu_v
眷	KdQ_
橱	Gr_f
捆	JqG_
膏	UnG_
惩	DtC_
塌	Fb_f
虞	PoD_
痰	RwW_
敞	MwC_
耕	GhG_
耕	Gh
疗	Rv_f
胧	Nx_s
魄	BbA_
绑	Se_q
氛	Za_a
莹	Ze_r
挚	Jz_f
帆	Mn_r
朽	GtS_
毯	ElW_
沅	VgA_
搂	JkX_
屉	PlT_
蔼	HuS_
妃	XcF_
徘	De_q
煞	<wT_
粥	GkG_
邱	Rt_q
阐	Nk_t
罕	Af_g
鹰	ReS_
煌	WbE_
旷	Br_d
颖	Lt_v
颖	Lt
颖	LtL_
彬	GgV_
拴	JiE_
窟	Ap_r
霍	Me_g
炭	WrW_
炭	Wr
蒲	Hv_v
胁	N>A_
熙	CcT_
嗤	OwC_
萍	HvF_
绥	SmX_
绥	Sm
绥	SmS_
畜	UsB_
畜	Us
畜	UsU_
滔	VmE_
滔	Vm
滔	Vm_m
滞	Vm_v
妾	UxQ_
寥	AjV_
蝴	Cy_b
聘	HbS_
俨	ItR_
绰	Sy_t
阮	PgA_
愣	Yq_a
栽	YlG_
荐	HyD_
慷	Yr_d
屯	LuT_
贮	MaT_
唾	Oe_g
吁	Ot_f
溯	Vw_b
塑	KnF_
厦	RtW_
厦	Rt
厦	Rt_t
眨	QrZ_
翔	EjX_
杖	GxZ_
丙	TiB_
缕	SkX_
淹	Vd_s
叩	Op_d
滥	VkQ_
滥	Vk
滥	VkV_
噗	OwD_
喽	OkX_
醋	QhB_
焚	GgW_
葱	HsC_
憾	YlC_
剃	Kr_g
卸	Fz_q
挟	Jd_d
哨	Om_b
禄	Pe_d
浇	VlA_
潭	Vq_t
卓	Yb_t
肆	EvF_
躯	ScX_
虐	Pe_b
宛	AnC_
拙	Jw_r
啸	OeQ_
霉	MiB_
囡	Qx_b
榜	Gu_a
弗	GhF_
币	RmB_
币	Rm
币	RmR_
抿	Jc_s
祠	PjT_
庐	Rp_s
旱	Bf_g
肢	NyX_
烁	WcV_
髦	Ev_s
虾	CfX_
鼎	Qk_d
钊	LhZ_
斩	LrZ_
汁	VyZ_
馈	<c_v
纲	SnX_
捞	Jz_a
竿	KfG_
肖	MnX_
蚊	CwW_
谬	UjV_
抒	Js_f
呐	Oi_b
氓	Ul_s
仄	RiZ_
戳	Je_s
悯	YnW_
崖	WrF_
崖	Wr
崖	Wr_r
涩	V>Z_
焕	W>D_
祈	PrQ_
筐	KcE_
蚂	Cm_v
烤	WyS_
砸	Tc_v
琳	EgG_
璧	PuE_
樵	GeT_
摧	JwE_
踩	ZmG_
瓣	Um_r
瓣	Um
瓣	UmU_
芯	HcX_
钓	Ls_r
跋	ZwB_
揪	JtW_
蟹	<>C_
瑟	EeC_
瑟	Ee
瑟	EeE_
窥	AdA_
窥	Ad
丐	FsG_
咙	Ox_s
茄	HwQ_
呻	Ob_t
奢	DzS_
咪	Ok_v
寝	AkX_
侨	Ir_g
霖	MgG_
巢	MbG_
讪	UwS_
沸	Vg_g
溃	Vc_v
浆	Kn_d
滢	VzE_
栅	GnT_
栅	Gn
栅	GnG_
纽	Sb_b
庶	RhT_
逊	DvZ_
辜	YuG_
咯	Ow_w
畔	BkF_
咏	Ou_d
膜	Nm_w
瞬	Q>F_
逮	EkZ_
觅	MnA_
吱	OyX_
唠	Oh_a
爵	Mr_f
梭	Gv
嗦	OyV_
噜	O>B_
祟	WuS_
狡	DuX_
絮	XoV_
殆	Dv_w
彭	FkV_
胀	NkT_
珂	Ej_d
镶	Lp_g
酌	Qs_r
懊	YbD_
崩	Wn_b
盯	QjD_
懦	YmQ_
咚	Ow_d
咚	Ow
咚	OwO_
喃	Om_d
茂	HlR_
梗	GxB_
矫	Lr_g
矫	Lr
矫	LrL_
鲍	<sC_
鲍	<s
鲍	<s<_
沦	Vi_s
嗜	OyB_
咨	K>_w
亥	Us_e
熄	WrC_
昼	RbT_
浊	VcZ_
诅	UqZ_
搓	Je_a
潇	VhQ_
灼	Ws_r
敝	KmW_
甭	GmB_
蕉	HeT_
邓	XpD_
邓	Xp
邓	Xp_p
孽	HuD_
骇	Mu_e
揖	Jo_g
揍	JdD_
沪	Vp_g
届	Pb_f
拷	JyS_
棱	GfW_
扛	J>_d
扛	J>
扛	J>J_
辽	VjZ_
澄	Va_d
芒	Hu_s
舰	DnA_
舰	Dn
舰	DnD_
疆	GfT_
舆	ElA_
剔	Bd_g
宵	Am_b
侣	Io_w
垒	VvF_
藉	HgB_
宠	AxC_
嗅	OrD_
禽	InV_
忿	A>C_
胶	NuX_
兀	TaW_
乍	PzA_
嚣	Ot_w
帜	MoA_
赘	AmZ_
嘈	Oc_w
穴	AxE_
靖	Ue_b
靖	Ue
靖	UeU_
珏	Ee_r
萌	Hb_b
洽	Va_w
旬	SbX_
撩	JdV_
瑚	Ey_b
脯	NmF_
熏	FqT_
沧	ViC_
秽	Tw_b
拧	Ja_f
粪	KhA_
淮	Ve_g
冥	Ab_r
嗨	OvB_
愕	YoS_
悴	Yu_t
拌	JkF_
佐	Ir_a
奚	MsD_
瘾	RpC_
瘾	Rp
瘾	RpR_
哆	On_b
剂	Wh_g
藩	HvB_
榴	G>B_
肌	Nn_f
弓	GgG_
捶	Je_g
阑	NgQ_
裴	Ep_q
琢	Ea_r
眯	Qk_v
溅	Vm_s
燥	WoG_
憋	KwC_
丸	ZuW_
砌	Tl_a
札	GlZ_
郝	Fw_q
榆	Ga_g
绞	SuX_
蜀	QsC_
惦	Yr_w
靡	RgE_
葫	Hy_b
漾	Ve_d
骸	Au_e
窑	Af_r
嘘	OpW_
笃	KmD_
绊	SkF_
畴	Be_f
绎	SxF_
婢	Xb_e
谜	UkZ_
蕊	HcC_
尿	Pk_b
萱	ZtT_
薛	Hc_r
琪	EhQ_
辙	LnW_
苑	HnC_
喳	OgT_
苛	Hj_d
唔	Oe_w
帅	HmS_
鬓	EvA_
涕	VkG_
甸	SbD_
诀	Ud_f
麟	RlF_
肘	NjZ_
巩	<n_r
搔	JxC_
吆	Os_t
馒	<bX_
汀	VjT_
驯	MmX_
驯	Mm
驯	MmM_
憔	YeT_
俭	Ia_v
楷	GlB_
煎	KhT_
鬟	Ev_q
禹	RnC_
峡	Wd_d
寇	Aa_t
芭	HcB_
酿	QuR_
萎	HtX_
篱	KnV_
绷	Sn_b
疙	RiZ_
疙	Ri
疙	RiR_
浒	VuF_
笺	Kt_s
栋	GlV_
聋	Xh_s
蔚	Hs_f
蔚	Hs
蔚	HsH_
塾	UzF_
蚀	<cS_
叽	On_f
轧	LlZ_
蓦	Mo_v
蓦	Mo
蓦	MoM_
韬	GpE_
凰	NbE_
檀	GuT_
孕	Sd_t
杠	G>G_
杠	G>
螺	CbV_
稣	<tS_
斧	XrF_
冀	KlA_
挫	JiF_
祺	PhQ_
苇	Hg_q
晦	BiB_
晦	Bi
晦	Bi_i
牡	Ff_v
牡	Ff
牡	FfF_
魅	BaG_
啪	OjB_
桨	KnG_
睹	QzD_
惚	YsC_
戮	Jv_s
矗	YqQ_
襄	Po_g
崭	WlR_
柿	Gu_v
盂	TjQ_
眩	QuS_
龟	<g_e
蹦	Zw_b
膛	NmF_
膛	Nm
膛	NmN_
铸	Le_f
贸	C>_v
棕	GaS_
梧	Ge_w
菌	HqT_
峻	WvW_
峻	Wv
眶	QcE_
斌	WlZ_
凛	KuS_
呃	OrC_
搏	Jm_f
搏	Jm
搏	JmJ_
贬	MrZ_
蹋	Zb_f
虏	P>_s
溺	VgG_
猾	Da_b
汹	Vx_r
袱	PiD_
袱	Pi
袱	PiP_
攘	Jp_w
隅	Pb_b
锻	Le_b
泻	VaS_
窍	A>S_
骡	MbV_
撮	JbX_
凹	Ua_w
尹	Er_t
澜	VnG_
翘	La_f
俘	ImD_
涡	Vo_e
吠	Od_r
皂	BlZ_
虔	PwQ_
娼	XbB_
翩	Pq_f
阎	N>E_
攒	Jf_v
褥	Pr_f
蹄	Zu_v
丞	VkT_
嵇	TzW_
嵇	Tz
嵇	TzT_
怡	Yv_w
诡	U>C_
穗	TfC_
悍	YbF_
髻	Ev_w
厕	Rm_g
珑	Ex_s
甩	NlS_
寨	AhG_
筛	Kh_v
盅	OyQ_
陡	PzD_
靴	<i_s
咦	OdG_
熹	FoT_
渠	VcG_
惋	YaC_
腥	NbE_
腥	Nb
腥	NbN_
鹃	OnS_
胭	NqD_
狸	DbF_
狸	Db
狸	DbD_
苔	Hv_w
捻	JiC_
捻	Ji
捻	JiJ_
糙	KfZ_
糙	Kf
糙	KfK_
嘀	OuD_
稼	TaA_
魁	Ba_d
俞	Ah_t
棣	Ge_d
扒	JaB_
迸	KhZ_
晖	Ba_s
晖	Ba
晖	BaB_
啥	Oa_t
牟	Vf_v
眸	QvF_
漱	Vg_a
拇	Jb_v
镯	LqS_
尧	LtA_
憧	YuF_
炳	Wt_e
凿	Wk_r
忏	YfC_
泳	Vu_d
寅	AtB_
寅	At
寅	At_t
陕	Pd_d
呸	OgT_
呸	Og
呸	OgO_
俟	IvD_
桔	Gf_w
槽	Gc_w
钝	Ll_r
矜	SjV_
撅	Jr_a
缆	SkA_
欤	St_a
憬	YbV_
闸	NbZ_
饺	<uX_
镑	Lu_a
毋	Bw_r
窜	Ao_t
砂	TvS_
砂	Tv
砂	TvT_
吝	Wo_s
溶	VaW_
涅	VbF_
募	Mo_a
殡	DaR_
绫	SfW_
毡	El_t
琛	EaG_
砰	Tf_d
怠	VoC_
晤	Be_w
篓	KkX_
匿	Ch_w
卦	Ff_t
鸳	NcS_
秉	TeB_
悖	YyD_
漓	Vw_b
椒	GvX_
冶	Kv_w
鹦	MxS_
傀	IbA_
碾	Tp_q
琦	Ed_f
渗	VvV_
渗	Vv
蚕	TdC_
沏	Vl_a
褪	PrZ_
殉	DsB_
芙	HdF_
槛	GkQ_
豁	AoW_
柯	Gj_d
唬	Op_b
唬	Op
唬	OpO_
扳	JrX_
澳	VbD_
偎	Ib_q
狞	Da_f
跺	ZnG_
懈	YmF_
冈	NxG_
辄	Lh_s
匾	CpQ_
儡	IbB_
铎	LxF_
拭	Jl_a
锯	Lp_t
蒜	HsS_
蒜	Hs
蒜	Hs_s
擅	JuT_
瘪	Rq_s
龚	XhA_
疤	RcB_
茸	HhR_
诃	Uj_g
愫	YeV_
嘎	Ot_s
嬉	Xf_w
隋	Pr_b
壤	Fp_g
谛	Uu_v
鸯	Ds_t
蓉	ZwR_
雁	RiE_
兑	KoA_
兑	Ko
兑	KoK_
雯	MwW_
嘶	OhR_
幢	MuF_
撼	JlC_
艇	DeZ_
艇	De
艇	DeD_
疮	RiC_
肮	Nu_b
勺	SuS_
勺	Su
瑶	Em_r
奠	KqD_
埠	Fr_t
棘	GnG_
棘	Gn
棘	Gn_n
瑛	EhD_
锄	Lq_a
煽	Wp_f
呛	OiC_
烹	UvT_
咂	Oc_v
馋	<>_d
壕	FuA_
瘫	RxE_
侈	In_b
铲	LuR_
蛰	JzC_
囔	Oy_q
弘	Gv_g
刃	<uR_
叱	OlC_
迪	BzD_
坤	Fb_t
癖	Ro_r
咻	OiG_
锤	Le_g
券	Kd_a
簌	Kg_a
酣	QhT_
玺	<e_r
茹	Hx_w
挠	JlA_
瞟	QqS_
嗔	OyA_
粱	V>_d
剌	Go_g
赁	Ie_v
屎	PkS_
曙	BqZ_
墅	BsF_
娄	Kx_s
娄	Kx
娄	KxK_
匈	Sx_r
雍	UrE_
炊	W>C_
薯	HqZ_
簸	KhX_
赎	My_d
嗟	Oe_a
舐	Yc_s
栖	GqQ_
峭	Wm_b
仕	IfS_
啃	Oz_b
宦	Ac_g
琅	EuR_
沛	Vt_v
孰	UdZ_
郡	Eo_q
鳞	<kF_
弛	GcC_
禀	UqS_
蔓	HbX_
蔓	Hb
蔓	HbH_
飙	Dd_b
拈	Jy_w
枫	GnX_
厮	RhR_
厮	Rh
晏	BaX_
汰	Vd_r
眺	Qk_d
眺	Qk
眺	QkQ_
恬	YyT_
邹	<e_q
睨	QeA_
祀	PcS_
潺	VpD_
簧	KhA_
簧	Kh
簧	KhK_
沌	Vl_r
璋	EyZ_
蔬	HzA_
筵	KrZ_
惆	YnF_
癞	Rg_v
啐	Ou_t
辗	Lp_q
馨	FnB_
睫	QtZ_
瓢	Qs_v
褒	PiG_
狈	DmB_
缴	S>W_
辐	LtB_
俐	It_g
秤	Tf_d
秤	Tf
秤	TfT_
缉	So_g
疫	Rn_t
徨	DbE_
琉	EuA_
笋	KeR_
揽	JkA_
尉	Ps_f
纺	S>F_
芜	Hf_s
睬	QmG_
偕	IlB_
厥	Rw_a
谤	Uu_a
桓	GtT_
兢	YaA_
勋	Om_a
戊	LrW_
厄	RcE_
窿	ApE_
拗	Js_a
淌	VmT_
腆	NqA_
幺	Sy_w
椭	Gp_b
炯	Wn_f
雏	<eE_
澈	VnW_
靶	<cB_
彦	UrV_
窦	Ay_d
磊	TtT_
磊	Tt
捂	Je_w
擒	Ji_b
笙	KrE_
惰	Yr_b
葆	HiG_
葆	Hi
葆	HiH_
鹉	TzS_
臊	NoG_
耦	Gb_b
隧	PkZ_
踉	ZuR_
帚	Ea_v
亨	Uv_f
沁	VcQ_
豹	Ds_r
跄	ZiC_
倔	Ip_r
瘩	Rh_w
驹	Ms_w
隍	PbE_
迄	IzZ_
卵	Gu_q
呱	OmG_
嫦	Xm_v
谚	UuV_
谚	Uu
谚	UuU_
斐	EwF_
匡	Ce_d
墩	FdW_
掐	J>E_
噎	Of_d
凋	KnF_
凋	Kn
凋	KnK_
颁	A>_v
颁	A>
颁	A>_>
朔	Kw_b
绽	SaZ_
迢	<zT_
噤	OgS_
秧	Td_t
袒	PbT_
捺	JdS_
奎	DfF_
烙	Ww_w
舵	Da_s
嫖	XqS_
叼	OjT_
飕	NxE_
憨	VwC_
榨	Ga_q
酉	Qy_r
袅	Sp_b
逾	AhZ_
孚	MdF_
廖	RjV_
涎	VrZ_
涎	Vr
涎	VrV_
畸	Bd_f
卅	MsA_
膨	NkV_
孜	DwZ_
诫	Ul_g
趴	Za_q
幔	MbX_
遁	RqZ_
谕	Ua_g
箍	KjC_
梆	Ge_q
嗣	Oq_f
橡	G>A_
炽	WoA_
荀	HsB_
琼	EuV_
啄	Oa_r
舫	D>F_
蘸	HqT_
蘸	Hq
蘸	HqH_
亢	Un_d
潦	VdV_
潦	Vd
莘	HuS_
莘	Hu
莘	HuH_
尬	Zi_g
尴	Zh_d
娟	Xo_b
咎	Wy_w
梵	Gg_b
庠	ReX_
庠	Re
庠	ReR_
呷	ObX_
铮	L>_f
彰	YvZ_
侃	IoA_
佃	IbD_
窒	AtF_
坍	Fn_r
坍	Fn
坍	FnF_
鞍	<aX_
恃	Yf_f
渣	VgT_
婊	Xe_q
蔷	HfQ_
酥	QtS_
冕	B>A_
冕	B>
冕	B>B_
醇	QuD_
谑	UpE_
殓	Da_v
喀	Oa_w
喀	Oa
喀	OaO_
蹙	LvZ_
撵	Jd_s
贿	Mr_b
咀	Oq_f
咀	Oq
咀	OqO_
婪	GgX_
抡	Ji_s
渝	Va_g
崎	Wd_f
炬	Wc_q
藕	Hg_b
吮	OvA_
钗	LxC_
阙	Nk_a
噩	Eo_w
荤	Zl_g
饷	<b_w
庇	RlB_
汲	Vs_f
龛	AoX_
恺	YwC_
垢	Fr_w
垢	Fr
垢	FrF_
磅	Tu_a
瀑	Vb_d
渍	Ve_v
肋	N>_s
忱	Ym_s
迂	TjZ_
哽	OxB_
蛤	Ca_w
屐	PdX_
阱	Ph_f
纂	KqV_
耿	HwG_
楫	Go_g
楫	Go
楫	GoG_
赦	FwW_
赦	Fw
赦	Fw_w
蜷	CkC_
蜷	Ck
绉	S>E_
扼	JrC_
阜	Rc_t
诛	UgZ_
馅	<>E_
睦	QfF_
涧	VnB_
鹳	HeS_
砚	TnA_
颉	Fo_v
鼾	RhF_
诏	U>Z_
墟	FpW_
麓	Gg_s
颅	Yp_v
腼	NtQ_
坳	Fs_a
坳	Fs
坳	FsF_
饯	<t_s
傧	IaR_
蛊	CqG_
幌	MbA_
褚	PzC_
褐	PbS_
缅	StQ_
崽	WbC_
涤	VwG_
裔	PnA_
锥	LeZ_
贷	LmD_
猩	DbE_
猩	Db
猩	Db_b
胥	Vz_b
奄	Db_s
孺	DmQ_
猿	Df_q
哧	OfW_
暄	BaT_
甬	Sm_t
遏	BsZ_
滕	Nk_d
籁	Kg_v
淳	VuD_
淳	Vu
淳	VuV_
蠕	CmQ_
窖	Af_w
蹂	ZsG_
亵	PjZ_
垮	FdS_
纣	SjZ_
粤	BkS_
甥	Re_a
濂	VrW_
姣	XuX_
姣	Xu
姣	Xu_u
贻	Mv
羹	EtD_
剿	Mg_g
惺	YbE_
惺	Yb
惺	YbY_
萤	Zc_t
谒	UbS_
谒	Ub
谒	UbU_
妩	Xf_s
镣	LdV_
攫	JqX_
睇	QkG_
碴	TgT_
碴	Tg
蟆	Cm_w
豚	NaT_
辖	La_w
恤	YrQ_
犄	Fd_f
骈	Mk_g
粽	KaS_
厘	RbF_
髓	ArZ_
绯	SeF_
嗒	Oh_w
炙	NwZ_
垄	Xf_s
垄	Xf
垄	XfX_
洼	VfF_
蹬	Za_d
侥	IlA_
殃	Dd_t
茧	Hc_f
弁	VhB_
饽	<yD_
韧	Gp_a
壬	Er_b
刁	JtD_
毓	IbA_
掺	JvV_
蟀	Cu_t
惴	YwQ_
谟	Um_w
踞	Zp_t
躏	Zh_b
熵	WuA_
瞿	QqE_
篆	KeA_
帷	MeW_
逍	MnZ_
诲	UiB_
裘	Ku_q
汶	VwW_
镖	LqS_
艘	DeX_
拯	JvT_
彝	Ev_g
圃	Qm_q
殴	Cx_b
桦	Gl_t
霆	MeZ_
钵	LgT_
佬	Iy_s
茉	Hg_v
鹊	HbS_
昵	Bp_s
掸	Jk_t
娣	XkG_
隽	Es_f
倏	IyD_
萦	ZsV_
沃	VrD_
掇	JxX_
峙	Wf_f
戌	LrT_
卯	Gp_v
卤	Yb_s
闽	Nc_v
喔	OpF_
琵	Ee_s
藐	HdA_
搽	JhG_
榕	GaW_
雌	ZlE_
璞	EwD_
鸥	CxS_
讹	Ui_s
枢	GcX_
炫	WuS_
镌	LeS_
谴	UcZ_
琶	EeC_
惮	Yk_t
蹑	ZhX_
笠	Ku_s
霄	Mm_b
懋	GgC_
啾	OtW_
啧	Oe_v
腋	NuW_
揿	Jl_a
蜓	CeZ_
栓	GiE_
倪	IeA_
卉	Yh_g
恣	K>C_
驿	MxF_
竺	KgZ_
黝	Qs_a
冢	Aa_r
簪	KaB_
啬	FkQ_
羲	ElS_
沮	Vq_f
羁	Q>_v
勘	Hl_a
彪	PnV_
唆	OvW_
舶	DbB_
蜻	Ce_b
淞	VgV_
苞	HsC_
峨	Wj_s
荔	H>_a
垣	FtT_
沥	Vr_a
俺	Id_s
哝	Oa_q
纨	Sz_r
戟	Yy_s
犁	ThF_
暨	RcT_
讼	UaV_
觑	PwA_
囱	BcG_
蕾	HmB_
惕	YbS_
饲	<jT_
啤	Ob_e
盔	RwQ_
捎	Jm_b
砾	TcV_
蹭	ZkB_
瞌	QfQ_
瞌	Qf
谄	U>E_
蟋	CrC_
蟋	Cr
咄	Ow_r
缭	SdV_
锚	LhB_
蕃	HrB_
赃	MrF_
拄	JuE_
骰	AnT_
锈	LtS_
绛	SwF_
弩	XxG_
嚎	OuA_
悚	Yg_w
诘	Uf_w
忸	Yb_b
攥	JkV_
嘁	OlV_
逞	OeZ_
粟	QkS_
旭	ZbX_
舀	Me_t
鸠	Zs_f
搪	Jr_w
豺	DjC_
腌	Nd_s
怩	Yp_s
谀	Ue_e
贰	Lg_v
痘	Rt_d
靳	<r_f
苓	HiS_
撂	Jb_w
杉	GvS_
橹	G>B_
芷	HzZ_
薰	HfQ_
倌	IaC_
桅	G>C_
汩	VbG_
篙	KuG_
枷	Gw_f
姬	Xc_f
丕	Gt_q
颏	Ui_v
禺	BnV_
霎	MuX_
赊	MiS_
拎	JiS_
醺	QfQ_
瓮	AvW_
瘟	RbQ_
湛	Vh_s
晾	BuV_
掣	Fh_f
俾	Ib_e
赳	Zy_f
豢	KdA_
沐	Vg_v
黔	QiV_
闰	NeR_
佯	Ie_t
稠	TnF_
瘁	Ru_t
羿	Jh_t
掖	JuW_
玳	ElD_
闩	NtS_
穹	AgQ_
渲	VaT_
茨	Hk_a
隘	PkQ_
褶	PjB_
虱	ZrC_
蔗	HrT_
驮	MdT_
啷	Or_q
禧	Pf_w
窠	AbG_
烽	WwE_
垛	FnG_
葵	HaD_
驭	Mx_t
肇	PwF_
羔	EtG_
蛾	Cj_s
哮	OyD_
箕	Kh_f
壑	YxF_
遐	PpZ_
踵	ZeB_
裱	Pe_q
蜕	CkA_
霹	Mo_r
巅	Wa_v
怂	IiC_
谏	UgQ_
沽	VyG_
蚌	CeB_
翎	Is_f
伎	IyX_
缔	Su_v
讷	Ui_b
跤	ZuX_
沓	KbT_
馁	<mX_
喋	OlG_
箩	Kq_b
罅	Fu_f
邑	Oc_t
嚏	OyZ_
镂	LkX_
爿	Kp_b
鹄	FoS_
翟	JeD_
锵	Lk_f
紊	WsV_
舷	DuS_
椰	Gh_q
啜	OxX_
筏	Ki_s
倭	ItX_
龊	ZuZ_
龊	Zu
椎	GeZ_
刨	Sc_g
亘	TbT_
亘	Tb
酝	Qg_t
禾	ThE_
夙	NdS_
瘸	Rw_e
腴	Ne_e
怦	Yf_d
帛	BmB_
帛	Bm
娓	Xp_s
缄	Sl_w
璜	EhA_
咿	OiR_
亟	VxT_
恻	Ym_g
伽	Iw_f
翡	EjF_
妲	XbT_
龌	ZuF_
宕	AtD_
屹	WiZ_
沂	Vr_t
媛	XmX_
媛	Xm
猖	DbB_
耘	Gg_t
漪	Vd_f
篡	KqV_
诽	UeF_
颦	ZtB_
痨	Rz_a
诒	Uv_w
礁	TeT_
礁	Te
骏	MvW_
蜗	Co_e
肴	Xr_b
笆	KcB_
哺	OmB_
雳	Mr_a
皎	BuX_
唷	Ou_b
烬	Wr_d
怆	YiC_
憩	FrC_
瘴	RyZ_
镰	LrW_
瞰	QhW_
诳	UdE_
悒	YoC_
孑	DjE_
芍	Hs_r
茁	Hw_r
屿	WsT_
淀	VaZ_
槟	GaR_
霁	Mw_g
溥	Vm_f
刍	<eC_
纬	Sg_q
萃	Hu_t
掂	Jr_w
遽	PaZ_
懿	FkC_
奕	UwD_
阖	NfQ_
鹭	ZwS_
讴	UcX_
镀	LrX_
赂	Mw_w
戎	LrR_
毗	Bl_q
臀	Pn_b
霭	MuS_
匝	CmZ_
颧	He_v
诙	UrW_
栩	GjX_
吭	Ou_b
斫	TrZ_
呓	OhZ_
氅	Mw_s
畦	BfF_
谥	UkQ_
吨	Ol_r
杳	Gb_t
挛	Uw_f
芥	Hi_g
坞	FsW_
铿	LxF_
癸	AtD_
哒	OdZ_
耙	GcB_
痢	Rt_g
踅	JrZ_
赭	FwZ_
溉	VrA_
咆	OsC_
俸	IdF_
皓	Bf_w
漩	V>Z_
喟	Ob_b
缨	SmX_
瞄	QhB_
跷	ZlA_
熔	WaW_
熔	Wa
诌	U>E_
噬	Ok_a
滇	VyA_
祯	Py_v
叟	EyX_
擂	JmB_
酋	KqQ_
惫	WbC_
踹	ZwQ_
嚓	OaS_
衾	Iv_q
猝	Du_t
聂	HxX_
岚	WnX_
踊	Zs_v
寐	AkG_
骋	MbS_
渎	Vy_d
瑁	EbQ_
婷	Xu_f
颔	Io_v
疚	R>_r
缥	SqS_
缥	Sq
陇	Px_s
蜿	CaC_
蜿	Ca
糜	Rg_d
戛	Tq_s
诿	UtX_
牍	Ky_d
乩	Yo_s
梓	GuZ_
淆	Vx_b
恿	SmC_
岑	WiV_
蝠	CtB_
锢	Lq_t
谆	UuD_
赈	Mr_q
偃	IcX_
炖	Wl_r
柩	Gc_r
魇	RdA_
疟	Re_t
衮	PaV_
橐	YoG_
滓	Va_r
鹂	TnS_
歼	Df_f
罔	Nk_s
橙	Ga_d
膺	Re_b
飒	UnX_
蛆	CqQ_
轶	Ld_t
乓	Rt_r
洵	VsB_
澎	VkV_
杞	GcQ_
诣	UlB_
渭	Vb_b
彤	NuV_
钳	LhT_
怄	YcX_
濡	VmQ_
蹩	KwZ_
猥	Db_q
粲	Yx_d
诨	Ua_s
娌	XbF_
缪	SjV_
啮	Oz_r
煦	BsT_
芹	HrQ_
冉	Rr_b
馀	<iT_
隼	EyS_
蝙	CpQ_
疵	Rz_s
胰	NdG_
阂	Nu_e
锭	LaZ_
韶	Y>S_
噫	OyC_
唏	Ox_v
绺	Sy_w
谩	UbX_
妯	XbZ_
蚪	CkD_
涸	Vq_t
暧	B>X_
鲤	<bF_
榄	GkA_
桧	GiG_
桧	Gi
饬	<i_a
臧	KlC_
圳	FmZ_
茗	Hn_w
橄	GhW_
嗑	OfQ_
俚	IbF_
舔	FtV_
诮	Um_b
闾	No_w
柢	Gc_r
筠	KfS_
睿	YaQ_
鄂	Os_q
戍	Lr_r
垦	Rf_d
熨	PjW_
詹	<r_r
谍	UlG_
饨	<l_r
峦	UwW_
纾	Ss_f
绚	SsB_
嚅	OmQ_
蝗	CbE_
孵	GmD_
茎	Hx_a
胚	NgT_
慑	YhX_
臆	NyC_
稷	TbW_
辍	LxX_
菇	Hx_t
馄	<b_s
鞘	<m_b
嗫	OhX_
嗥	Ob_t
槌	GrZ_
聒	HyG_
佚	Id_t
蚩	WtC_
豕	As_e
幛	MyZ_
於	<i_d
樟	GyZ_
讣	UyF_
邸	Cu_q
缈	SqV_
箸	KzZ_
臃	NuE_
嘹	OdV_
蝌	Ct_d
淇	VhQ_
痪	R>D_
迥	NoZ_
颍	Lk_v
痉	Rx_a
徙	DzZ_
耷	DhD_
沼	V>Z_
臻	TfT_
霏	MeF_
扉	PeF_
褛	PkX_
囤	Ql_r
郜	Fo_q
鳌	A>A_
鸾	UwS_
瘠	Rk_b
悻	YfF_
偌	Ih_w
瞑	Qa_r
陛	PlF_
腑	Nr_f
掬	Js_d
孀	XmQ_
痞	Rg_w
褴	PkQ_
蚤	XcZ_
哔	Ol_t
焊	WbF_
泸	Vy_q
槁	GuG_
槁	Gu
鲫	<r_q
瀛	VuX_
掳	Jp_a
皋	Bd_t
岖	WcX_
痹	Rb_g
泞	Va_f
菁	He_b
辕	Lf_q
泠	ViS_
枭	SgX_
噘	Or_a
榭	Gs_f
恸	Yg_a
擞	JxW_
掰	J>_f
猢	Dy_b
糠	Kr_d
诟	Ur_w
敕	GoW_
涿	Va_r
淖	Vy_t
缤	SaR_
喏	Oh_w
慵	Yr_v
磐	DnT_
伧	IiC_
邢	Th_q
琨	Eb_s
涣	V>D_
湃	VjE_
澹	V>_r
斓	WnG_
菠	HvX_
坯	FgT_
嫣	XtS_
婕	XtZ_
玷	Ey_w
岌	Ws_f
氢	Zx_a
劾	Ui_a
圜	Qq_q
椽	GeA_
涮	Vm_g
狲	DdV_
岱	LwD_
乒	RtR_
啻	Ua_w
衅	RqF_
幡	MrB_
衢	De_f
恙	Ec_t
瑕	EfX_
恫	YnT_
磋	Te_a
聆	HiS_
貂	D>D_
貂	D>
掮	Jp_b
杓	Gs_r
睽	QaD_
漉	Vr_s
眈	Qm_s
驸	Mi_f
瑙	EmB_
鬈	EvC_
淙	VaS_
佥	AmQ_
鹑	UdS_
侩	IiG_
燎	WdV_
椿	GdB_
闵	Nw_v
铐	LyS_
楠	Gm_d
堰	FcX_
诠	UiE_
裨	Pb_e
姘	Xk_g
赡	M>_r
馍	<m_w
浣	VaA_
髅	AkX_
瞠	QmF_
宓	AcR_
窈	As_a
锹	LtW_
喁	Ob_b
嗝	Ot_b
懑	VhC_
庖	RsC_
箧	KcD_
牯	FyG_
皿	Qm_b
抠	JcX_
硫	TuA_
逵	FfZ_
硝	Tm_b
柚	Gb_t
惬	YcD_
雉	IdE_
觞	<m_f
蚱	CpZ_
钹	LwB_
邬	SpW_
纶	Si_s
犀	PkF_
痊	RiE_
螂	Cr_q
讫	UiZ_
檬	GzA_
湮	VqF_
骷	Ay_d
蹿	Za_t
跚	ZnT_
泯	Vc_s
啕	OsF_
蹶	Zr_a
诋	Uc_r
搡	JxG_
朕	NkD_
茜	HqQ_
瞳	QuF_
皖	BaA_
柬	Gq_f
芋	Ht_f
侬	Ia_q
泅	Vq_e
犊	Fy_d
滂	Vu_a
獭	Dg_v
潼	VuF_
莓	HiB_
佻	Ik_d
怏	Yd_t
偻	IkX_
梏	Gf_w
铡	Lm_g
噔	Oa_d
煨	Wb_q
勖	Bq_a
荃	HiE_
曝	Bb_d
摺	JjB_
蚓	Cg_t
幂	Ab_v
癌	RoW_
脐	Nw_g
蚯	CrT_
耄	Yr_s
忡	Yq_t
嫡	XuD_
荼	HiT_
涓	Vo_b
剽	Qs_g
汕	VwS_
阉	Nd_s
濯	VjE_
豌	TkC_
纭	Sg_t
摈	JaR_
後	DsW_
峒	WnT_
璀	EwE_
蹒	Zh_e
蘑	HrT_
鸷	JzS_
钏	LmC_
笞	Kv_w
蛀	CuE_
涟	VlZ_
嵘	WzG_
咫	RoA_
荟	HiG_
榷	GaE_
髯	Ev_b
刽	IgG_
娑	VvX_
胤	As_b
缰	StT_
跛	ZpX_
桀	NfG_
杵	GfC_
窕	Ak_d
阕	NaD_
蒿	Hu_g
糯	KmQ_
蠹	YcC_
粑	KcB_
唢	Om_e
昙	BgT_
炜	Wg_q
扈	PoC_
纫	S>_r
胄	BnZ_
暴	Bh_d
茬	HyF_
哂	OqS_
坷	Fj_d
酪	Qw_w
恪	Yw_w
捱	JrF_
涔	VwV_
铛	LmE_
璨	Ex_d
鸨	LyS_
辘	Gr_s
捋	Jm_f
鹞	MuS_
迩	<vZ_
蠊	CrW_
皈	BrX_
欹	Dj_a
俪	It_b
蹊	ZmD_
碉	TnF_
悸	YtD_
泱	Vd_t
馔	<cA_
燮	WwX_
骥	MlA_
邃	AaZ_
撬	Je_s
俎	IiQ_
釜	Xe_d
鳅	<tW_
韭	Et_f
黏	Tk_w
皙	GrB_
蟠	CrB_
咤	Oa_s
蔻	Za_t
堑	LrF_
缙	SwB_
扪	Jn_v
蹇	AhZ_
奁	DcX_
挈	E>_f
蹰	Zr_f
蚣	CaV_
肾	Hx_b
咛	Oa_f
榛	GdT_
佞	IgX_
呶	OxX_
疹	RiV_
黠	Qf_w
曜	BjE_
娲	Xo_e
匕	Lb_e
翱	By_f
遑	BeZ_
雹	MsC_
鸢	Ls_t
轲	Lj_d
爰	MfX_
舂	DeC_
曷	Bs_e
迨	VoZ_
缜	SyA_
怵	Yg_r
覃	Qb_t
冽	Kd_g
柠	Ga_f
鲸	<uV_
骊	Mt_b
旌	<iE_
婀	Xp_f
罄	Fn_r
鳝	<e_w
谧	UcQ_
柑	GhT_
磷	TkF_
捍	JbF_
泌	VcR_
颀	Rt_v
卞	UfB_
戾	Pd_r
酵	QyD_
妪	XcX_
咔	OyF_
霾	MdF_
淅	VgR_
戕	KlQ_
讦	Uf_f
骁	MlX_
孪	UwD_
濒	Vd_v
汛	Vz_t
艄	Dm_b
莞	ZgA_
踝	ZbG_
姗	XnT_
峪	Ww_t
骼	Aw_w
嵩	WuS_
缢	SkQ_
蜈	CoD_
唁	Ou_t
懵	YhQ_
诩	UjX_
谪	UuZ_
浃	Vd_d
钿	LbD_
喑	Oy_t
喵	OhB_
褡	Ph_w
鹌	DlS_
忑	FcT_
珀	Eb_q
浚	VvW_
咋	OpZ_
忐	YtC_
桠	Gw_t
袂	Pd_v
绌	Sw_r
桎	GtF_
痣	RfC_
郢	Oe_q
抨	Jf_d
媪	XbQ_
狎	DbX_
岫	WbX_
渚	VzZ_
靛	EnZ_
臼	Ej_r
蛔	Cq_w
翌	Ju_t
揄	Ja_g
匍	Sm_q
揆	JaD_
盎	DqA_
淤	V>_d
馥	TbW_
僮	IuF_
恹	YrD_
喙	OeA_
阒	NqD_
殇	Di_f
踽	Zr_b
锷	LoS_
笏	KsD_
蜢	CdQ_
磴	Ta_d
圭	FfG_
琥	Ep_b
涝	Vz_a
弼	GbG_
撷	Jo_v
秆	TfG_
黍	Ti_d
斡	Yy_d
歆	Y>X_
缮	Se_w
帏	Mg_q
挎	JdS_
轼	Ll_a
掼	Jb_v
剁	Ng_g
脓	Na_q
琏	ElZ_
剐	Oi_g
陨	Po_v
粼	Kn_v
铢	LgZ_
礴	Th_f
螫	FwC_
焙	Wu_w
柘	GtZ_
敖	Aa_w
呗	OmB_
徵	DeW_
猷	KqD_
瘤	R>B_
枇	Gl_q
鳄	<oS_
耆	YrB_
砥	Tc_r
狰	D>_f
嘤	OmX_
咭	Of_w
邋	MkZ_
仃	IjD_
棂	GeW_
诰	Uf_w
胛	Nb_f
脍	NiG_
楹	GsQ_
磔	TfG_
翕	Ao_f
濠	VuA_
摒	Jp_g
粕	Kb_q
抉	Jd_f
瀚	Vy_f
崛	Wp_r
悌	YkG_
荩	Hr_d
肱	NrV_
噶	OhS_
狷	Do_b
荞	Hr_g
挞	JdZ_
遢	BjZ_
蓑	HpT_
樽	Gk_f
忾	Yz_d
榈	Gn_w
斛	<m_d
榔	Gr_q
趄	Zq_f
杷	Gc_q
呦	Os_a
恚	FfC_
煜	Wb_r
坂	FrX_
岐	WyX_
鳖	Kw_a
獗	Dr_a
饪	<eR_
夯	D>_g
碱	Tl_w
氧	Ze_t
侏	IgZ_
彗	EeE_
蜃	RpC_
磺	ThA_
寰	Aq_q
釉	RkB_
宸	Ar_q
嶙	WkF_
噼	Oo_r
谗	U>_d
宥	Ar_b
觥	<mA_
牖	Kp_v
诤	U>_f
锟	Lb_s
矶	Tn_f
佼	IuX_
铀	Lb_t
飓	NxQ_
峥	W>_f
埔	Fm_q
拽	Jb_s
裆	PmE_
箔	KvB_
伫	IaT_
嗖	OeX_
巽	CcA_
箝	Kj_g
髭	Ev_s
啖	OwW_
夔	KcW_
犒	Fu_d
绔	SdS_
绔	Sd
忝	TdV_
擤	Jr_g
蹴	Zv
腺	Nb_d
楔	G>D_
誊	Kd_r
泵	TkB_
羌	ElQ_
峋	WsB_
胫	Nx_a
荚	Hd_d
畹	BaC_
鬃	EvS_
钜	Lc_q
忪	YaV_
跻	Zw_g
曦	Be_s
胯	NdS_
汴	VuF_
秸	Tf_w
牒	KlG_
踮	Zr_w
氲	ZbQ_
磬	FnT_
嗬	Oh_f
僭	IcB_
闳	NrV_
孱	PdD_
檄	G>W_
撺	Ja_t
癯	RqE_
铄	LcV_
遛	C>Z_
靼	<bT_
鸪	YsG_
茏	Hx_s
钺	Ll_s
珞	Ew_w
昀	Bs_d
俑	Is_v
虬	ClQ_
芮	HiR_
荧	Zw_t
媲	Xb_s
銮	Uw_s
鑫	Ll_s
谙	UyA_
诓	UcE_
虻	Cu_s
汾	Va_a
睐	Qg_d
搐	JuB_
茴	Hq_w
袈	Wp_f
捅	Js_v
嗷	OaA_
黜	Qw_r
魑	BaW_
闼	NdZ_
跎	Za_s
谯	UeT_
蜮	ClT_
贲	Yh_v
锌	LuX_
臾	Ei_t
飨	SrR_
匐	StB_
甄	QfW_
麽	RgV_
彀	Fg_b
竣	UvW_
阪	PrX_
绦	SwG_
猬	Db_b
迤	IcZ_
傥	ImA_
辇	Dd_s
讵	Uc_q
鸩	MlS_
雠	EuE_
雠	Eu
醮	QeT_
烩	WiG_
碣	TbS_
奘	KfD_
薮	HxW_
魍	Ba_b
聩	Hc_v
攸	IyW_
靓	EnA_
麒	Rl_g
樨	GpF_
蹉	Ze_a
裟	Vv_q
鹗	OsS_
睢	QeS_
蓓	Hi_w
靥	RdQ_
绾	SaC_
忤	YfW_
蟾	C>_r
徇	DsB_
炷	WuE_
佗	Ia_s
馊	<eX_
弑	Xg_a
襁	PgC_
咝	OsT_
燧	WkZ_
阗	NyA_
啭	OlS_
俳	Ie_q
鸶	SsS_
鸶	Ss
痔	Rf_f
壅	UeF_
笳	Kw_f
肪	N>F_
囿	Qr_b
弈	Uw_g
湍	VwQ_
躅	ZqS_
仞	I>_r
匮	Cc_v
皑	BwC_
噙	Oi_b
酗	Qx_r
弭	Gh_v
湎	VtQ_
胱	NmA_
晔	Bl_t
叵	Co_q
挹	JoC_
邝	Rp_d
夥	Bg_b
殒	Do_v
娉	XbS_
盥	EkQ_
栉	Gh_q
荑	HdG_
庾	Re_e
浔	Ve_f
邕	MoC_
繇	MuV_
楂	GgT_
凫	SnF_
祗	Pc_r
璇	E>Z_
僖	If_w
嵋	WpQ_
遨	AzA_
遨	Az
砒	Tl_q
犷	DrG_
潢	VhA_
愎	YiW_
芊	HfQ_
辔	Ss_w
揶	Jh_q
珈	Ew_f
氤	ZqD_
沱	Va_s
眇	Qv_v
偈	IbS_
怫	Yg_g
眦	Qz_s
谡	UbW_
貉	Dw_w
暹	BeZ_
锃	LoE_
踯	Zd_q
葺	Ho_g
悭	YxF_
圻	FrQ_
氯	Ze_d
囵	Qi_s
蛟	CuX_
囹	QiS_
姝	XgS_
鸵	Sa_s
蟑	CyZ_
锏	LnB_
竽	Kt_f
痼	Rq_t
堇	HoE_
挲	Vv_f
橇	Ge_s
琮	EaS_
洱	VhE_
伉	Iu_b
傣	Id_d
怼	XjC_
炀	WjD_
奂	<d_g
蝼	CkX_
鹧	RtS_
纡	St_f
湫	VtW_
栀	GrC_
贽	Jz_v
煊	WaT_
渤	Vd_a
囫	QsD_
狩	Da_f
劭	<>S_
钤	LiV_
泓	VgV_
昕	BrX_
翦	Kh_f
骞	Ah_v
睑	Qa_v
狙	Dq_f
麾	Rg_s
蓟	H>_g
骛	Sw_v
镳	LrT_
缦	SbX_
毂	Fl_b
渥	VpF_
濑	Vg_v
滟	VeC_
箴	Kl_w
绡	Sm_b
泗	VqS_
嗄	OtW_
旎	<i_s
鳗	<bX_
逡	VwZ_
褓	PiG_
葩	HbC_
崂	Wz_a
棹	Gy_t
萋	HyX_
徕	Dg_d
鱿	<z_r
黧	TsQ_
擘	Pu_f
伥	IkT_
茔	Zf_t
阍	NcB_
缟	SuG_
淦	VlG_
拮	Jf_w
婵	Xk_t
莠	HtS_
铰	LuX_
黎	Ts_d
赣	YmG_
氨	ZaX_
熠	WjB_
骅	Ml_t
膘	NqS_
蛹	Cs_v
垠	Fr_t
祚	PpZ_
蟒	Ch_g
笈	Ks_f
荻	HdW_
旖	<i_f
俦	Ie_f
嘭	OkV_
懔	YuS_
澧	Vq_d
泾	Vx_a
砺	Tr_a
篑	Kc_v
镫	La_d
遒	KqZ_
樾	Gz_s
儆	IsW_
瞽	FyQ_
篁	KbE_
逖	DwZ_
嶂	WyZ_
寤	Ak_w
诂	UyG_
唿	OsC_
帔	MpX_
觯	<m_t
阆	NuR_
胺	NaX_
筱	KiW_
萼	HoS_
矾	Tn_r
仟	IfQ_
罡	QtZ_
恽	Ya_s
颢	Bv_v
邯	Ht_q
壹	Fa_d
碳	TwW_
淼	Kk_d
籽	KdZ_
帼	MqE_
麝	Rs_f
蠡	EcC_
镁	LeD_
倜	InF_
愠	YbQ_
郸	Ky_q
璎	EmX_
驷	MqS_
殁	Dn_v
酩	Qn_w
铤	LeZ_
邈	DbZ_
琊	Ej_q
矍	QqX_
唳	OpD_
鹘	AsG_
逦	TnZ_
噱	OpA_
鹜	SwS_
鹜	Sw
饴	<v_w
猗	Dd_f
嵬	WbA_
鳏	<q_d
杈	GxC_
咩	Oe_v
暝	Ba_r
痍	RdG_
鸱	CuS_
淄	VmB_
昶	UkB_
铝	Lo_w
昊	BtD_
稔	TiC_
铉	LuS_
刎	Sd_g
墒	FuS_
觊	WcA_
罹	QyE_
獐	DyZ_
徉	De_t
嬷	XrV_
玮	Eg_q
唰	Om_g
鹫	UzS_
恁	IeC_
鲨	Vv_a
鞑	<dZ_
鄱	Rb_q
逅	RoZ_
蜚	EcF_
箬	Kh_w
牝	Fl_q
酊	QjD_
隗	PbA_
愆	DgC_
裾	Pp_t
砭	TrZ_
蛎	Cr_a
啁	OnF_
闱	Ng_q
岬	Wb_f
蚨	CdF_
艹	Hc_w
骧	Mp_g
铣	LfA_
韫	GpQ_
葭	HfX_
硅	TfF_
觎	AhA_
觎	Ah
徜	DmC_
舛	NfC_
蚝	Ce_s
钠	Li_b
忻	YrX_
挝	JjZ_
莅	Hi_r
剜	An_g
绶	S>X_
寮	AdV_
邺	Wp_t
阡	PfQ_
驽	Xx_v
孬	GxD_
拊	Ji_f
馗	Zk_d
顼	Et_v
砦	ZlT_
蓿	ZiB_
镬	LhX_
锲	L>D_
潍	VsE_
赝	Re_v
嫔	XaR_
蘅	Hd_f
摞	JbV_
祉	PzZ_
镞	L>D_
厩	TrA_
赧	FwX_
谲	Us_b
龇	Zz_s
臬	RqG_
篝	KhR_
泫	VuS_
汨	Vb_v
膻	NuT_
鏖	Rl_s
姹	Xa_s
舢	DwS_
鬻	Gg_b
呔	Od_r
疽	Rq_f
酢	QpC_
痂	Rw_f
镭	LmB_
栾	UwG_
晁	Bk_d
颚	Os_v
烊	We_t
睾	RqF_
铱	Lp_t
衲	Pi_b
荏	HiE_
倨	Ip_t
崴	WlX_
殛	DvT_
赍	Yi_v
畿	Ss_s
滦	VuG_
陟	PzD_
螭	Cw_b
媾	XhR_
蠃	Uc_s
薨	Hd_s
钰	Le_r
羚	EiS_
苯	HgT_
綦	HsV_
谌	Uh_s
鲲	<b_s
漳	VyZ_
酶	QiB_
佝	Is_w
灸	<uW_
觐	HeA_
罂	Mm_r
殚	Dk_t
趔	Zd_g
莆	Hm_q
玑	En_f
藜	Hs_d
甯	Ac_v
螳	CmF_
邂	<>Z_
潸	Vg_b
獠	DdV_
酡	Qa_s
轸	LiV_
薏	HyC_
鲛	<uX_
厝	RhB_
醴	Qq_d
龈	ZuR_
亳	Ua_s
秣	Tg_v
枰	Gf_d
搦	JgG_
苻	Hi_f
柙	GbX_
祜	Py_g
歙	Aj_a
翊	Uj_t
钾	Lb_f
嬴	Ux_t
焘	EjT_
颌	Ao_v
侗	InT_
潞	Vz_w
菏	Hv_f
弋	Ly_e
碘	TqA_
腓	NeF_
瓯	CxW_
昱	Bu_t
锺	LeB_
琬	EaC_
吒	Or_s
陲	Pe_g
娩	X>A_
娆	XlA_
衿	PiV_
绻	SkC_
癣	R>E_
辚	LkF_
麋	Rl_d
搠	Jw_b
嫫	Xm_w
沆	Vu_b
欷	Xm_a
蘧	HpZ_
羯	EbS_
雒	WoE_
纥	SiZ_
淬	Vu_t
圄	Qe_w
骜	AmA_
骜	Am
溟	Va_r
佰	ItB_
幄	MpF_
苒	HrR_
圩	Ft_f
肓	Ul_b
舸	DjG_
邙	Ul_q
睥	Qb_e
搴	Ah_f
兖	UvA_
蜍	CiT_
缱	ScZ_
袤	Ps_f
漕	Vc_w
夤	NaB_
赉	Gk_v
笄	Kt_g
汞	<kG_
骓	MeZ_
廪	RuS_
韪	BzG_
缁	SmB_
逶	TxZ_
遴	KfZ_
烨	Wl_t
祛	PfV_
钙	LfS_
佘	IsS_
濮	Vi_r
馏	<>B_
赅	Mu_e
焱	WwW_
焱	Ww
艮	Rg_b
锗	LzZ_
郧	Om_q
飚	NxW_
缇	SbZ_
陂	PpX_
蜥	CgR_
羸	Ue_s
苫	Hy_w
虢	Mj_b
迳	X>Z_
胴	Nn_w
嗲	Ox_b
町	BjD_
杼	Gs_f
衽	PeR_
狯	DiG_
蜴	CbS_
锉	LiF_
卟	OyB_
鬣	Ev_d
汜	VcS_
铙	LlA_
蚋	CiR_
嵯	We_a
蓼	HjV_
疋	VzS_
郦	Tn_q
掴	JqE_
谔	UoS_
肛	N>G_
蓍	HyB_
氮	ZwW_
镐	LuG_
琰	EwW_
纰	Sl_q
炔	WdQ_
聿	Ef_t
烃	Wx_a
茱	HgZ_
菡	Hv_r
猱	DsG_
蕲	HyR_
辂	Lw_w
蓁	HdT_
铧	Ll_t
擢	JjE_
蒺	HrD_
錾	Lr_s
痫	RnG_
獒	Ad_r
蒯	Hn_g
菟	Ha_r
苜	Hq_v
骝	M>B_
骢	MrC_
荥	ZkX_
筮	K>_e
裎	PoE_
婺	SwX_
姒	Xv_e
俅	Ik_r
耋	YrF_
偾	Iy_v
瓒	Ef_v
阚	NvW_
烷	WaA_
峤	Wr_g
菅	Zc_f
洙	VgZ_
汐	VnX_
妊	XeR_
叁	VdV_
泷	Vx_s
狒	Dg_g
佶	If_w
涪	Vu_w
岷	Wc_s
涫	VaC_
疡	RjD_
墀	FpF_
墀	Fp
仵	IfW_
膂	<i_b
疥	Ri_g
呖	Or_a
邳	Gt_q
蕨	Hw_a
烯	Wx_v
铬	Lw_w
鳍	<yB_
铠	LwC_
蔺	HnE_
墉	Fr_v
珉	Ec_s
鄢	Tt_q
畲	IsB_
郓	Al_q
湄	VpQ_
轾	LtF_
魈	Ba_v
潋	VmW_
膑	NaR_
郅	Tf_q
瞵	QkF_
菸	H>_d
椁	GuD_
蜇	JrC_
杲	BgG_
迓	CjZ_
钲	LtZ_
晟	Bl_f
葳	HlX_
灏	Vv_v
镍	LrG_
辎	LmB_
猕	DgV_
柞	GpZ_
牦	Fe_s
邛	<pQ_
崆	Wa_a
囗	Qw_e
瑷	E>X_
螓	CdT_
嫱	XfQ_
嫒	X>X_
嫒	X>
哐	OcE_
嶷	WdZ_
滁	VpT_
娠	Xr_q
仝	I>T_
珩	Ed_f
郗	Xm_q
沭	Vg_r
玟	EwW_
糗	KrD_
戬	Wb_s
瑗	EmX_
垸	FaA_
婧	Xe_b
镛	Lr_v
莒	Ho_w
跆	Zv_w
酆	Wk_q
漯	VbV_
漯	Vb
鳟	<k_f
枸	Gs_w
酮	QnT_
砷	Tb_t
霈	Mv_v
钛	Ld_r
酯	QlB_
鲑	<fF_
氟	Zg_g
仡	IiZ_
郴	Gg_q
妤	Xs_f
瘀	R>_d
冼	KfA_
噻	OaF_
邡	<pF_
邾	Gp_q
邗	Fp_g
哞	OvF_
钯	LcB_
篪	Kr_b
郄	Xv_q
榉	GmF_
岍	Wt_g
镔	LaR_
柰	Gs_b
妗	Xi
粞	KqX_
茯	HiD_
诶	UvD_
菖	HbB_
硌	Tw_w
芩	HiV_
锰	LdQ_
铵	LaX_
粳	KxB_
芪	Hc_s
镢	Lr_a
鼐	Sk_d
晗	Bi_w
钨	LsW_
枳	GoA_
鞅	<d_t
湟	VbE_
氰	Ze_b
萸	He_e
苎	Zt_b
酰	QfA_
鲟	<e_f
鲻	<mB_
珲	Ea_s
芎	HgX_
燔	WrB_
嬗	XuT_
辊	Lb_s
仨	IvS_
稞	TbG_
缫	SmG_
蔫	HsT_
塬	FrV_
钚	LgB_
崮	Wq_t
佤	IwW_
蛳	Ch_v
氦	Zu_e
膈	Nt_b
铂	LbB_
垩	WfE_
鄯	Ko_q
伢	Ic_f
篾	Kl_r
糅	KsG_
腈	Ne_b
垅	Fx_s
豉	TkX_
帙	MdZ_
铆	Lg_q
荠	Hw_g
谶	UlT_
钴	LyG_
衩	PxC_
啵	OvX_
痈	Rm_t
蹼	ZwD_
蝈	CqE_
岜	WcB_
肽	Nd_r
藓	#N
嵊	Wt_s
疱	RsC_
滹	Vp_f
訇	Su_g
坨	Fa_s
咣	OmA_
藿	HmE_
苡	Hv_e
爻	Xx_t
锂	LbF_
砣	Ta_s
薹	HfF_
砝	TfV_
犍	FeZ_
醛	QhE_
芾	Ht_v
栎	GcV_
蓖	Hb_s
勐	Dq_a
摁	JqC_
孳	KsD_
煲	IoW_
锑	LkG_
秭	TsR_
垭	Fw_t
侔	IvF_
瓴	IsW_
蒌	HkX_
楝	GgQ_
钎	LfQ_
镉	Lt_b
苕	H>S_
脘	NaA_
坻	Fc_r
痿	RtX_
龉	Zu_w
龃	ZuQ_
澍	Vk_f
擀	JyF_
溧	VqG_
碜	TvV_
龋	Zu_b
溘	VfQ_
謇	Ah_r
焯	Wy_t
鳃	<bC_
瓤	Ph_v
蜉	CmD_
籼	KwX_
嗵	OsZ_
傈	IqG_
乜	Jl_b
螟	Ca_r
蒡	Hu_a
鄞	He_q
谵	U>_r
沤	VcX_
苷	HhT_
蕤	HaE_
钼	Lq_v
旃	<i_b
嘣	Ow_b
枞	Gi_e
苋	HnA_
呲	Oz_s
醚	QkZ_
桉	GaX_
肄	LdF_
阄	N>_f
鎏	Vu_s
蕻	HvA_
苁	Hi_e
榫	Ge_t
腱	NeZ_
珐	EfV_
秫	Tg_r
锴	LlB_
獾	DhE_
轭	LrC_
钒	Ln_r
螯	AcA_
螯	Ac
蛭	CtF_
痧	RvV_
槿	GhE_
癜	RaX_
磙	TpV_
僳	Iq_d
耒	Gl_e
铳	LuA_
焖	WnC_
缛	Sr_f
噌	OkB_
陉	Px_a
峄	WxF_
汊	VxC_
腚	NaZ_
蒴	Hw_b
唑	OiF_
饕	OpR_
螨	Ch_e
洄	Vq_w
晷	By_w
讧	U>_g
锶	LbC_
髋	AaA_
髋	Aa
趵	Zs_r
洮	Vk_d
岿	WhE_
庥	RiG_
蝣	C>D_
煅	We_b
砻	Xt_s
轳	Ly_q
溏	Vr_w
腭	NoS_
垧	Fb_w
狍	DsC_
邰	Vo_q
悱	YeF_
崧	WgV_
玎	EjD_
鞣	<sG_
鲈	<y_q
屙	Pp_f
鹈	KrS_
疝	RwS_
渑	Vo_s
捭	Jb_e
酽	QtR_
槎	Ge_a
缃	SgQ_
砀	TjD_
泔	VhT_
鹕	YnS_
趿	ZsT_
胝	Nc_r
戡	Hl_s
鼬	EkB_
羟	Ex_a
芗	HsR_
榘	IcG_
蓊	Ha_f
毽	ElE_
毽	El
鼹	EkX_
糌	KyB_
篦	Kb_s
叻	O>_s
骐	MhQ_
蓥	Zl_t
橛	Gr_a
趸	<zD_
瘘	RkX_
疴	Rj_d
疣	Rz_r
徭	Dm_r
碓	TeD_
朐	Ns_w
灞	Vm_b
碚	Tu_w
锛	Ld_g
莪	Hj_s
荨	He_f
鲇	<y_w
荦	Zf_s
笤	K>T_
麂	Rl_b
倥	Ia_a
疃	BuF_
苣	Hc_q
鳕	<mE_
雎	Qe_f
蘖	HuG_
扦	JfQ_
枋	G>F_
莼	Hs_s
茭	HuX_
矽	TnX_
薤	HdT_
埝	FiC_
偬	IsC_
亻	IdR_
薷	HmQ_
仉	InZ_
皴	VwX_
樯	GfQ_
稹	TyA_
痱	ReF_
镊	LhX_
鹬	SnS_
鹬	Sn
沔	Vc_f
餮	DiR_
鲅	<wB_
撸	J>B_
霰	MnW_
踟	Zd_w
桡	GlA_
馐	<eB_
喱	OrF_
泮	VkF_
咴	OrW_
岙	RdW_
甑	KbW_
郯	Ww_q
胼	Nk_g
訾	Zl_r
氖	Zs_b
碇	TaZ_
刈	Xh_t
栝	GyG_
栝	Gy
鲢	<lZ_
跹	ZfZ_
跹	Zf
莜	HiW_
豸	Dz_e
砼	Ti_a
篌	IiD_
垴	Fw_r
垓	Fu_e
椴	Ge_b
鲭	<e_b
呋	OdF_
锆	Lf_w
屣	PdZ_
盱	Qt_f
酐	QfG_
铍	LpX_
莴	Ho_e
杌	GtA_
碛	Te_v
摭	JrT_
淝	VnC_
瘢	Rd_b
镏	L>B_
箨	KjF_
餍	RdR_
餍	Rd
犸	Dm_v
庑	Rf_s
醪	QjV_
洇	VqD_
逑	KuZ_
抟	JgS_
箐	Ke_b
蚬	CnA_
筚	Kl_t
鲠	<xB_
眙	Qv_w
氡	Zw_d
劢	<>_v
岘	WnA_
椤	Gq_b
埭	Fe_d
嶝	Wa_d
籀	KjB_
萘	HdS_
蕈	Hq_t
濉	VqE_
黩	Qy_d
溆	VtX_
腠	NdD_
鬲	Tn_d
蚧	Ci_g
鲱	<eF_
鲶	<iC_
嘞	O>_a
菰	Hd_v
莨	HuR_
趼	Zt_g
桕	Ge_f
硷	Ta_v
蜊	Ct_g
芫	HgA_
铩	LxG_
鸹	FyS_
菔	HnX_
蛉	CiS_
甾	MbZ_
凇	KgV_
鳜	<r_a
圮	Fc_q
茕	Zz_t
椋	GuV_
牾	Fe_w
鄄	Qf_q
浠	Vx_v
鏊	AlA_
鏊	Al
郾	Cx_q
鳎	<b_f
柽	GxF_
崤	Wx_b
吡	OlB_
瘙	RxC_
凼	KuD_
铖	Ll_f
氐	Cl_r
衄	RqB_
鲵	<eA_
楮	GzC_
镓	LaA_
蠲	KqS_
椹	Gh_s
堀	Fp_r
茌	HiF_
仫	IrV_
毳	El_s
燹	AaW_
妁	Xs_r
鹁	YdS_
鬯	Xu_s
铯	L>C_
阊	NbB_
坩	FhT_
葚	Hh_s
笸	Kc_w
鲧	<rV_
镝	LuD_
蝮	CiW_
鲎	M>_g
俣	IoD_
薅	Hx_f
倬	Iy_t
黟	Qn_b
窨	Ay_t
胪	Ny_q
鸫	LvS_
麇	RlT_
鳔	<qS_
愍	CwC_
愍	Cw
瘌	Rg_g
戗	Ic_s
罘	QgF_
綮	PwV_
赀	Zl_v
圹	Fr_d
樗	GmS_
顸	Ft_v
箪	Kk_t
癔	RyC_
羧	EvW_
蔸	HpA_
筌	KiE_
蛄	CyG_
桫	GvV_
洹	VtT_
洌	Vd_g
猡	Dq_b
苄	HuF_
崃	Wg_d
麈	RlE_
檗	PuG_
猞	Da_t
氘	ZhD_
禳	Pp_g
妣	XlB_
呤	OiS_
耜	GcS_
糍	KkS_
戢	Ol_g
螅	CqC_
螅	Cq
埚	Fo_e
逋	MzB_
猁	Dt_g
醍	QbZ_
庋	RyX_
桄	GmA_
詈	Qu_s
镒	LkQ_
鲳	<bB_
隈	Pb_q
铋	LcR_
糁	KvV_
糨	KgC_
濞	Vr_g
铌	Lp_s
畛	BiV_
洚	VwF_
颟	Hi_v
缬	So_v
鸬	YpS_
暌	BaD_
谘	U>_w
莳	Hb_f
脔	Uw_e
焐	We_w
瓠	Ds_v
蚍	Cl_q
蟊	ScC_
醐	Qy_b
潴	VdZ_
羼	PeE_
昝	WyB_
坭	Fp_s
殍	DmD_
殍	Dm
穰	Tp_g
骶	Ac_r
蛸	Cm_b
缶	FuF_
缶	Fu
苴	Hq_f
砬	Tu_s
蠖	ChX_
啶	OaZ_
栲	GyS_
骘	Pz_v
蟥	ChA_
鼋	Ga_s
薜	Ho_r
腩	Nm_d
觇	YoA_
楦	GaT_
桴	GmD_
瑭	Er_w
蒗	HvR_
诔	Ug_s
葶	Hu_f
簋	KrQ_
睚	QrF_
钍	LfT_
髹	EvG_
溷	VqA_
瘰	RbV_
溽	Vr_f
嘏	YfX_
蒹	HkW_
堞	FlG_
褙	Pl_b
禊	P>D_
荽	HmX_
燠	WbD_
怙	Yy_g
剡	Ww_g
苈	Hr_a
籴	Ru_d
秕	TlB_
粜	Wu_d
笕	KnA_
蚴	Cs_a
踬	Zr_v
棰	Ge_g
觚	<m_v
孛	YaD_
嚯	OmE_
哓	OlA_
跞	ZcV_
鲡	<t_b
簟	Kq_t
箅	Kb_g
嗪	OdT_
栊	Gx_s
苌	HkT_
楸	GtW_
昴	Bg_q
螵	CqS_
筲	Km_b
鳇	<bE_
浯	Ve_w
劬	So_a
缂	S>_d
笥	KjT_
塄	Fq_a
跗	Zi_f
菀	ZnC_
歃	Fe_a
疬	Rr_a
唛	OeW_
溱	VdT_
黻	WmX_
髫	Ev_a
澶	VuT_
翥	ZjZ_
翥	Zj
瘿	RmX_
暾	BdW_
纛	EvV_
橥	DzG_
蛞	Cy_d
枧	GnA_
颛	Wq_v
齑	We_r
淠	Vb_g
菪	ZtD_
钕	Lx_b
刿	Wn_g
谠	UmA_
阏	N>_d
鼙	FyB_
娈	UwX_
趺	ZdF_
螈	CrV_
荜	Hl_t
杪	Gv_v
呒	Of_s
蠓	CzA_
捩	JpD_
螽	WcC_
阋	NeA_
憷	YgZ_
荛	HlA_
雩	MgS_
郏	Dk_q
氙	ZwX_
瓿	UoW_
卮	RtC_
缒	SrZ_
怛	YbT_
芟	HnS_
枘	GiR_
坼	Fr_r
鹩	DvS_
蹁	ZpQ_
豇	Tk_a
蛴	Cw_g
趑	Zk_a
缣	SkW_
怃	Yf_s
椐	Gp_t
尻	Pz_d
蝓	Ca_g
涠	Vq_q
辋	Ln_d
铒	LhE_
辏	LdD_
髀	Ab_e
孓	Vj_r
谝	UpQ_
剀	Wc_g
虺	TaC_
臌	NkX_
蛏	CxF_
掊	Ju_w
郇	Sb_q
锔	Lp_f
碲	Tu_v
曩	Bp_g
铊	La_s
骟	Mp_f
镪	LgC_
鹆	Ws_t
佾	Ia_b
洧	Vr_b
耩	GhR_
伲	Ip_s
妫	X>_d
橼	GsA_
侑	Ir_b
殄	DiV_
钇	Lz_t
戋	Tl_f
桷	G>_v
砘	Tl_r
硖	Td_d
砗	TlC_
啉	OgG_
黥	QuV_
岢	Wj_d
愀	YtW_
窳	Am_v
爨	EnW_
榇	GqC_
蕖	HcG_
垆	Fy_q
饧	<jD_
囟	Bx_b
茑	Hs_b
鳙	<r_v
畀	BhB_
畀	Bh
坜	Fr_a
鹪	EtS_
蝻	Cm_d
嘧	OaW_
煳	Wy_b
嫘	XbV_
鸸	TqS_
缧	SbV_
氚	ZmC_
赜	Ce_v
孥	XxD_
脬	NmD_
髑	AqS_
肼	Nh_f
墁	FbX_
蓣	Hj_v
礅	TdW_
觏	HrA_
洎	VrQ_
瘕	RfX_
哳	OjR_
悫	FaC_
倮	IbG_
缑	SiD_
舨	DrX_
鸲	SoS_
鸲	So
怍	YpZ_
揎	JaT_
徼	D>W_
鞯	<hD_
棼	Gg_a
酃	Mo_q
祢	P>V_
螬	Cc_w
罱	Qm_d
缵	Sf_v
陬	PhX_
肫	Nl_r
钽	LbT_
跬	ZfF_
朊	NgA_
馓	<nW_
愦	Yc_v
绐	Sv_w
犰	DzQ_
莸	HdZ_
绨	SkG_
葑	Hf_f
璩	EpA_
皲	AlX_
戽	Pk_g
嗉	OeV_
丨	Ys_r
襻	Pg_f
襞	Pu_q
徂	DqC_
氆	El_d
绱	SmS_
谳	UmD_
蘩	HwV_
裉	Pr_d
骖	MvV_
鲂	<>F_
彖	EaT_
菘	HgV_
旒	<iA_
邴	Ti_q
惝	YmC_
阃	NqG_
篼	KpA_
礞	TzA_
旰	BfG_
黾	Ob_s
锞	LbG_
萁	HhQ_
祧	Pk_d
瞀	SwQ_
甓	PuW_
埤	Fb_e
跫	<nZ_
氇	El_a
鲔	<r_b
砩	Tg_g
卣	Yq_q
甏	FvW_
圯	Fc_t
貘	Dm_w
媸	XwC_
觌	YkA_
蜱	Cb_e
萆	Hb_e
锇	Lj_s
毵	Vv_s
踔	Zy_t
蛱	Cd_d
堙	FqF_
堙	Fq
揸	JgT_
镆	Lm_w
跏	Zw_f
铗	Ld_d
飧	NiR_
遄	WqZ_
罴	QfT_
痖	Rw_t
劁	Et_g
铷	Lx_w
虼	CiZ_
浍	ViG_
毹	Ah_s
粝	Kr_a
鲮	<fW_
陔	Pu_e
绁	SlX_
龠	IoQ_
茺	HuA_
邶	Kl_q
蕞	HhX_
笊	KmZ_
缯	SkB_
艏	DkS_
襦	PmQ_
夼	Dm_d
铫	Lk_d
氍	Qe_s
埒	Fm_f
镅	LpQ_
瘅	Rk_t
汔	ViZ_
匦	ClZ_
皤	BrB_
皤	Br
颃	Un_v
嵛	Wa_g
囝	Qd_b
鳐	<m_r
蚰	Cb_t
骺	Ar_w
畋	BwT_
瓞	MdD_
髌	AaR_
狨	DlR_
泺	VcV_
泺	Vc
诼	Ua_r
刖	Nh_t
狳	DiT_
堍	F>A_
唼	OuX_
饔	UeR_
澌	VhR_
钌	Lv_f
裥	PnB_
砟	TpZ_
蠛	Ch_s
绋	Sg_g
跣	ZfA_
仳	Il_q
蟮	Ce_w
熘	W>B_
蔟	H>D_
忉	Y>D_
缗	ScB_
笫	KsR_
脲	Np_d
鹇	NgS_
镱	LuC_
硗	TlA_
湔	Vk_g
潲	Vt_b
崦	Wd_s
谇	Uu_t
嬖	PuX_
隹	Ec_e
蜩	CnF_
幞	MwD_
芴	HsD_
忄	YsX_
蠼	CqX_
艉	Dp_s
诜	UfA_
鲽	<lG_
蓐	Hr_f
祆	PtD_
炝	WiC_
蝾	CzG_
獬	DmF_
龅	ZuC_
铼	Lg_d
荬	Hv_d
舁	Eh_t
殪	Df_d
虮	Cn_f
搌	Jp_q
犋	FqA_
扃	Pn_w
蛲	ClA_
镲	LaS_
嗌	OkQ_
腧	Na_g
眄	QcS_
鲆	<f_d
鹣	KwS_
卺	VkC_
蚺	CrR_
犏	FpQ_
绠	SxB_
鲣	<xF_
瘼	Rm_w
瘛	R>C_
埏	FrZ_
茛	HrG_
郫	Bi_q
瘗	RdF_
陧	PbF_
廑	RhE_
镧	LnG_
玢	Ea_a
眚	ReQ_
廨	RmF_
缡	Sw_b
盍	FvQ_
醯	QuQ_
醯	Qu
螋	CeX_
酤	QyG_
钆	LlG_
赙	Mm_f
轺	L>_t
钫	L>F_
袷	Pa_w
埽	Fe_v
诎	Uw_r
岣	Ws_w
莩	HmD_
悛	YvW_
醅	Qu_w
杩	Gm_v
茼	HnT_
慊	YkW_
胗	NiV_
钭	LkT_
氪	ZyA_
蝥	SwC_
艨	DzA_
璺	EnE_
璺	En
耠	Ga_w
疰	RuE_
蜾	CbG_
鲩	<aA_
鹛	PqS_
痄	RpZ_
硇	Tb_b
袼	Pw_w
蒽	HqC_
磲	TcG_
劓	Rh_g
蝤	CkQ_
饫	<rD_
阌	N>X_
嫠	GwX_
觳	Fm_b
艟	DuF_
殳	Ns_r
鼷	EkD_
脞	NiF_
桤	GwC_
恧	TqC_
跽	ZcC_
噍	OeT_
镘	LbX_
蟪	CfC_
蟪	Cf
筇	K>_q
躐	Zm_d
篥	KqG_
笱	Ks_w
虿	<cC_
裰	PxX_
厍	RlS_
曛	BfQ_
喾	Mf_w
涑	Vg_w
钪	Lu_b
饣	<s_e
璁	ErC_
炅	BwG_
茳	Hv_a
郛	Md_q
癀	RhA_
嚆	Oh_r
瀹	ViQ_
搛	JkW_
撙	Jk_f
柝	Gr_r
诖	UfF_
踺	ZeZ_
踺	Ze
帻	Me_v
绲	Sb_s
缍	Se_g
敫	B>W_
猓	DbG_
鳓	<>_a
宄	AzG_
泖	Vg_q
掾	JeA_
犴	DfA_
谫	Uk_a
揲	JlG_
霪	MvE_
镦	LdW_
蝽	CdB_
龆	Zu_a
嵫	WkS_
甍	HqW_
硪	Tj_s
肭	Ni_b
舻	Dy_q
刳	Ds_g
诹	UhX_
酲	QoE_
癍	ReE_
兕	UaS_
糈	Kv_b
耱	GrT_
蕹	HrE_
驵	MqZ_
珧	Ek_d
矧	Ig_t
砑	Tc_f
迕	FzW_
簏	Kr_s
炱	VoW_
腽	NbQ_
舾	DqX_
慝	CoC_
慝	Co
胬	Xx_e
吣	OcQ_
瘵	RaS_
剞	Dj_g
劂	R>_g
醢	QrQ_
醢	Qr
飑	NxS_
敉	Kw_v
厶	Vs_e
炻	WtS_
絷	JzV_
貊	DtB_
阽	Py_w
醌	Qb_s
稃	TmD_
崞	WuD_
窬	Aa_g
悃	YqG_
舴	DpZ_
哜	Ow_g
锸	LfE_
僦	IvZ_
銎	<n_s
垤	FtF_
垤	Ft
嵝	WkX_
埸	FbS_
龀	Zu_s
蛩	<nC_
萑	He_g
褰	Ah_q
罨	Qd_s
猊	DeA_
麴	GwS_
铽	LlC_
铑	Ly_s
耢	Gz_a
螗	Cr_w
猹	DgT_
镩	La_t
锓	LeX_
鲚	<w_g
铕	Lr_b
罾	QkB_
洳	Vx_w
醵	QpA_
鲼	<y_v
帱	Me_f
胂	Nb_t
榀	Go_w
黼	Wm_v
儇	Iq_q
遘	HrZ_
箦	Ke_v
锾	LmX_
鹨	JvS_
躜	Zf_v
蚵	Cj_g
僬	IeT_
菹	HvQ_
胍	NmG_
鞲	<hR_
隳	PrV_
羝	Ec_r
胙	NpZ_
吖	Ok_t
狁	DvA_
昃	Br_e
驺	M>Z_
鹎	BiS_
牮	Lf_f
萜	Hm_w
埯	Fd_s
忮	YyX_
铞	Lo_v
筘	Kj_w
葙	HgQ_
搿	Jo_f
蓠	HnV_
酾	Qt_b
鍪	Sw_s
潆	VzV_
潆	Vz
厣	RdB_
缳	Sq_q
缏	SiX_
锎	Ln_g
鞴	<h_v
轵	LoA_
谂	UiC_
蛘	Ce_t
黹	Wk_v
颥	Mq_v
擗	Jo_r
吲	Og_t
逭	AcZ_
肷	N>Q_
臁	NrW_
谮	UcB_
醑	Qv_b
簦	Ka_d
鞫	<s_r
缌	SbC_
蛑	CvF_
芏	HfD_
蟛	CkV_
笮	KpZ_
狴	DlF_
舄	EsT_
庳	Rb_e
赆	Mr_d
耵	HjD_
粢	K>_d
畎	Bd_r
钔	Ln_v
黉	MhA_
煺	WrZ_
浼	V>A_
檎	Gi_b
菝	HjX_
嬲	Bx_a
荭	Hs_a
笾	K>Z_
坫	Fy_w
仂	I>_s
茈	Hz_s
酎	QjZ_
茇	HwB_
尢	Zy_w
哚	OnG_
佧	IyF_
镙	LbV_
纩	Sr_d
膪	Nu_w
耥	GmT_
缋	Sc_v
箢	KnC_
摅	JpC_
钷	Lc_w
馇	<gT_
廒	RaA_
坌	A>F_
稂	TuR_
胨	NlV_
糇	KiD_
佴	IhE_
醣	Qr_w
湓	VaQ_
饩	<zX_
掎	Jd_w
獯	DfQ_
芘	Hl_q
圬	FgS_
坶	Fb_v
鹾	Ye_a
漭	Vh_g
獍	DyA_
酏	Qc_t
瀵	VkA_
傺	IaS_
莶	Ha_v
墚	F>G_
眍	QcX_
鳘	Iw_a
浈	Vy_v
氕	Zr_q
骣	MpD_
铥	LeV_
穸	AnX_
鳆	<iW_
黪	QvV_
岵	Wy_g
芄	Hz_r
铘	Lj_q
嵴	Wk_b
芑	HcQ_
镟	L>Z_
蔌	Hg_a
蜞	ChQ_
钬	Lw_g
泶	MkX_
糸	Sv_v
舡	D>C_
耖	GvC_
瘭	RqS_
贳	LmS_
牿	Ff_w
滗	Vk_s
泐	Vp_a
躔	ZrF_
怊	Y>C_
镨	LkB_
搋	Jr_b
鲒	<f_w
艚	Dc_w
窀	Al_r
蒇	Hl_v
锪	LsC_
砹	ThX_
莛	HeZ_
庀	Rl_q
骱	Ai_g
碹	TaT_
碹	Ta
冱	KtE_
焓	Wi_w
肜	NvR_
刭	X>_g
鞒	<r_g
蒈	HlB_
稆	To_w
馘	KlT_
醭	QwD_
阢	PtA_
毪	ElV_
猸	DpQ_
滠	VhX_
礤	ThS_
瞍	QeX_
丿	RpE_
缲	SoG_
榱	GpT_
墼	LnF_
觖	<mD_
锬	LwW_
溻	Vb_f
廴	Zy_b
嫜	XyZ_
丶	Ud_b
鲺	<zC_
磉	TxG_
揞	JyA_
蹯	ZrB_
舣	Dx_r
鹱	ShX_
胩	NyF_
眢	NcQ_
锩	LkC_
掭	JtV_
堋	Fn_b
锘	Lh_w
栳	Gy_s
堠	FiD_
戤	Sq_s
铹	Lz_a
蒎	Hv_q
撖	JhW_
瘃	Ra_r
锿	Lp_w
弪	Gx_a
哿	WjG_
芈	Hf_v
擐	Jq_q
柃	GiS_
舯	Do_t
莰	Hf_a
鲰	<hX_
禚	PeT_
鲕	<tQ_
鲴	<q_t
艴	GhC_
碥	TpQ_
攴	Yx_q
锫	Lu_w
鄹	Hk_q
烀	Wr_f
鐾	Pu_s
膣	NaF_
轷	Lr_f
赇	Mk_r
鼽	RhZ_
菥	HgR_
腙	NaS_
塥	Ft_b
蟓	C>A_
劐	Hx_g
桊	KdG_
漤	VgX_
肀	Ey_t
鞔	<>A_
锊	Lm_f
耔	GdZ_
脶	No_e
岈	Wc_f
酴	QiT_
崾	WqX_
丌	Hj_e
楱	GdD_
舭	DlB_
軎	LoW_
鳋	<xC_
蚶	ChT_
捌	Jw_g
疳	RhT_
滏	VxE_
甙	LhT_
赓	Re_v
珥	EhE_
浜	VrA_
硒	TqX_
孢	DsC_
疸	RbT_
酚	Qa_a
旮	ZbG_
旯	Bz_s
犟	GoF_
锨	Lr_a
蚜	Cc_f
稗	Tb_e
矸	TfG_
尕	SvG_
硼	Tn_b
闫	Nv_t
勰	<>C_
轱	LyG_
溴	VrD_
峁	Wg_q
抻	Jb_t
涞	Vg_d
麸	EwD_
钡	LmB_
屺	WcQ_
儋	I>_r
轫	Lu_a
侉	IdS_
馑	<hE_
茆	Hg_q
畈	BrX_
荸	HyD_
芨	Hs_f
锒	LuR_
镗	LmF_
桁	Gd_f
沣	VeF_
芡	H>Q_
馕	<y_q
疖	Rp_f
溲	VeX_
菽	HvX_
檩	GuS_
绂	SwF_
枥	Gr_a
匏	DsC_
褊	PpQ_
隰	PbT_
珙	EhA_
怿	YxF_
黢	QvW_
哙	OiG_
嘬	ObX_
沩	V>_d
瀣	VxT_
耧	GkX_
碡	TeB_
箜	Ka_a
藁	HuG_
埙	Fo_v
狺	Du_t
逄	WfZ_
颞	Hx_v
锱	LmB_
戆	YwC_
琚	Ep_t
侪	Iw_g
渌	Ve_d
氩	Zw_t
疔	RjD_
疠	R>_s
穑	TfQ_
垡	IlF_
褫	Pr_b
艽	Hz_f
槲	Gm_d
哕	Ow_b
伛	IcX_
鲷	<nF_
裢	PlZ_
塍	NkF_
竦	Ug_w
钣	LrX_
谰	UnG_
椠	LrG_
埕	FoE_
葸	HbC_
耪	Gu_a
哌	Or_q
睃	QvW_
聃	HrD_
痤	RiF_
蜣	Ce_s
魉	BaT_
逯	EkZ_
槭	GlV_
榧	GcE_
畚	VdB_
亓	GhQ_
哏	OrG_
鹚	KsS_
翮	Tn_f
戥	Be_s
廛	RbF_
毖	LcR_
瘐	Re_e
祓	PwF_
圉	QfF_
聱	AhA_
耨	Gr_f
跸	Zl_t
縻	RgV_
庹	RhR_
喹	OdF_
瘥	Re_a
柒	VlG_
椟	Gy_d
硐	TnT_
拶	Jm_b
瘳	RjV_
矬	IdF_
跖	ZtZ_
漶	VoC_
亍	GjC_
骒	MbG_
鲥	<b_f
髂	Aa_w
帑	Xx_v
氽	IkT_
髡	EvA_
尥	Zs_r
爝	Wm_f
鼯	Ek_w
鹋	HbS_
熳	WbX_
荇	Hd_f
羰	EwW_
萏	H>E_
嘌	OqS_
铈	Lu_v
钋	Ly_q
罟	QyG_
柁	Ga_s
鲞	Kd_a
鳊	<pQ_
蔹	HmW_
鲐	<v_w
酹	Qm_f
脒	Nk_v
撄	JmX_
捃	Je_w
钐	LvS_
彘	ElD_
魃	BaW_
瘊	RiD_
梃	GeZ_
骀	Mv_w
绗	Sd_f
贶	MoA_
栌	Gy_q
芰	HyX_
豳	AaW_
眵	Qn_b
迮	PzZ_
晡	BmB_
悝	YbF_
艿	Hs_b
铟	LqD_
旆	<i_v
煸	WpQ_
酞	Qd_r
垌	FnT_
蹀	ZlG_
袢	PkF_
裣	Pa_v
揠	JcX_
乇	RlT_
痦	Re_w
喈	OlB_
癃	RpE_
鬏	EvW_
鲋	<i_f
郐	Ig_q
鼍	Oo_s
鳢	<q_d
裒	Pe_q
埴	FyQ_
媵	NkX_
谖	UmX_
觋	<iA_
旄	<i_s
槊	KnG_
鼢	Ek_a
筢	KjC_
洫	VrQ_
躞	ZwX_
殂	DqC_
眭	QfF_
苘	Hn_w
轹	LcV_
浞	VzZ_
笪	KbT_
趱	ZfF_
謦	Fn_r
蕺	Hl_g
攮	Jy_q
尜	VdV_
枨	GkT_
礓	TtT_
砉	Et_g
苤	HgT_
枵	GoS_
鋈	Vr_s
貔	Db_s
槔	Gb_t
垲	FwC_
鄣	Yy_q
髁	AbG_
觜	Zl_v
鲦	<wG_
樘	GmF_
硭	Th_s
鸺	IgS_
觫	<mG_
艋	DdQ_
渖	Va_t
铪	La_w
嗾	O>D_
槠	GuZ_
蘼	HrE_
痃	RuS_
舳	DbZ_
汆	Ru_d
俜	IbS_
颡	Xg_v
忭	YuF_
檠	HwG_
蒉	Hc_v
芤	Hd_s
唪	OdF_
瞢	HqQ_
硎	Th_g
蝰	CdF_
貅	DiG_
恝	E>C_
挢	Jr_g
唣	Ob_s
楗	GeZ_
闶	Nu_b
猃	Da_v
葜	H>D_
聍	Ha_f
裼	PbS_
肟	NgS_
屦	PdX_
锝	Lb_f
筅	KfA_
巯	X>A_
狻	DvW_
窆	ArZ_
苊	HrC_
膦	NkF_
鼗	KkX_
圊	Qe_b
赕	MwW_
蓰	HdZ_
澉	VhW_
锼	LeX_
踣	Zu_w
砜	TnX_
嗍	Ow_b
埘	Fb_f
狃	Db_b
呙	OiG_
镥	L>B_
阼	PpZ_
锖	Le_b
镡	Lq_t
筻	KxB_
篚	KcE_
岽	WlV_
渫	VlG_
窭	AkX_
陴	Pb_e
铴	Lv_f
锕	Lp_f
茚	He_q
簖	KlR_
钶	Lj_d
憝	UwC_
攉	JmE_
檫	GaS_
檑	GmB_
荮	Hs_f
辁	LiE_
镄	Lg_v
镎	La_f
髟	EvV_
榍	Gp_b
冁	Ky_q
苠	Hc_s
镤	LwD_
沲	ViC_
胲	Nu_e
脎	NxG_
锍	LuA_
齄	RhT_
钸	Lr_v
